Target_85	ATCTTTGCTTCTCCCATGTCCACCAGGAAGGCCCTGCCTCTGCCTGTCCCAACCCCCTGCCACCCACAAGGTTCACTCCGCCCCACCCTTGTCCTGTCCACGGAGTCAGGTGAATCAGAGTCAATCAGCCAGAGCCTTGAGAGCCTTTGAAGGGGAACTTTTGGTGAC	CCTGTCCACGGAGTCAGGTG
Target_11	ACTCTGTTTTGTAGTGCCAAGGTACAGGCTCTGCCTCTAAAGCTTACAGCAAAGTGGCCTGATCTCCACGGCAGTCAGATGGGTTGTATAAATGGAAAATGTAAAGCAGAAGCAAAGGACATCTAAAGGGTCAACACTTACAGTCGCTCTAATCTCAGAAGGTCTCCAAAGGTCTCTGGCTGTAGCATTTCTAGTTGGT	ATCTCCACGGCAGTCAGATG
Target_59	ATGCATGGTGAGTTTAAGGGCCTTGTTCTACGCTCCAGCTTCCTCTCTGTAGAACTTTCTCCCCGGGAGTCAGGTGAAGAGTACAGATTGAGTGCTAGAGACAGTGGTTTTCAGCAGAACTCTGAACCTAAGCTAAGGAAGTGATGACTCCTCTCCCTTCCTAACTATTTTCTAAGAATGTTTTGGCCCTCTG	TTCTCCCCGGGAGTCAGGTG
Target_06	CCTGTGCCCTTCATGTCTGACAATCTATGAAAGCCCCCTCATGGTCCCTCCCCAGGAATCAGGTGGGCTGTCTGGGCCCATGGGTGTCACTCACAGGCCCAGGGTGGATGCAGTGTAGGAGGAGCTCTCAGATTTCTTCCCTTGGGGAAGGGAACCAAGACATGCAGGACA	CCCTCCCCAGGAATCAGGTG
Target_63	AGAACCACACAGCTCTTTAGCACACAGTGGCTAAGCTTGCTGAAACTCTCTGAGATGGACAGTTCTGCTCTGGCTAGGATGGTCTTAATGTTCTTTCCACGGGAGTCAGCTGAGTTTTGCCTGGTGTTTCTTTTTGCTGTGACAGGGCAGCACTGAGTTTCAATG	CTTTCCACGGGAGTCAGCTG
Target_25	AGGGAATGTTGAGTTTAGATGGTCATCACTAATTTAATTGGGACAACTTTAATAACCAGAATCAATTATAACCTTCACAAGAGTCAGGTGGCTATGTTAATTTCTTTCTAATCATGTCTGTGATTCACTAATTCAATAATTATGGCCAATATACTGAATTTTCCATCAGGACTATCTTAACTGGATCCAA	ACCTTCACAAGAGTCAGGTG
Target_35	TCTGTTTTATAGAGGTGGAAACTGAGGCTCATAAAAATTTAGTATAGAGTTAGTATGGAGTAGAAACTGATTCCTATGCAAGCAAAAATAACATAGGGGAACTGACCACAGGAGTTAGGTGGAGTTAGGCCTATGTGAAATCTTCCTTCTCCCCTAACAATTTGCAGAATTAAGCACTTCAG	CTGACCACAGGAGTTAGGTG
Target_78	TGTCACCTCTCACTAGCACCTTCCAACCTCGGGAAGGTTGGAAGTAGGAGGAAAACAGGTGATTTGGGCCACAAGCAAGCCACACAGGAGTCAGCTGAGTTCGGGTGTGTGTGATAGTGTGCCCTGAGAACATGCTATTTTTTTTTTTTAGCTTACTTTCAGTTTCTTTCCCCAGTTTCCTGAGCACAGATCATGTGCATGGACACATGTATGGACATGAGC	AGCCACACAGGAGTCAGCTG
Target_48	TCACTTGTCCTCAGAGTCTCACAGCCAGCTAGGATCCATCAGTCAGCAAGTGCCGTTTCCCCTGCTCCACAGACGTCAGGTGGGTAGGGCAGGCCCCCAAGGACCACGCACAGCCTGCAGCAGAAGCAGCCCTTCCCCGAGAAGAGTTCTGCTGGTGGGGTCATCTCCAGGCACCAGAAATTC	TGCTCCACAGACGTCAGGTG
Target_29	TTGGTCAAATTCTCTCTTCTGAGGAGGCAGGAATTGAGGTTGCTGGCTTCACTACTGGTAACATAATTTGGTACCACAGGAGTCAGATGCATTATGCTGCTAACATTTCCACCCCTCCGCATTTGTATATTGAAGCCCTAACCCTCAGTGTGATGGCATTAGGAGATGAGA	GGTACCACAGGAGTCAGATG
Target_30	GTTGAAAGCATGTTCTTGATTATCCTTATGATCAAGATATAGTCAGATCATGCCATAACAGACTTTCTGTCATAACTGTCACAGAAGTCAGGTGCACTATTCATTGCTCTGAATATATCTGTGACCACGTTGTCCTCAAGTAATCATATAAAGTAAGAGCTTTATCCAATGCAACATTTC	ACTGTCACAGAAGTCAGGTG
Target_60	CATAGTGGTTGGACTAGTTGCCTTTCCCACCAGTAATATAGAACTGTTCCCTGTTCACCATATCCACAGCAACATCTACTATTTTTTTATTTTTTGATTATGGCCATTCTCACAGGAGTAAGGTGGGATCGCATTGTGAAACTTATTTTTTGAAGAGCGTGTTTTGACC	ATTCTCACAGGAGTAAGGTG
Target_65	TGTGTCCCAGGTAGAACTGCCAATTTGTGGCTCAAGAATAAGTTTAAGAATTGCAACCGACAGCCACAGGAGTCAGGTGAGCTACGATTCTTCAATAGAAGATGGTGTCCAAAAAAACAGAGATTCAAGAAAGTCCCTTCCCTGACCGAATGTGAATTCAGCGTC	ACAGCCACAGGAGTCAGGTG
Target_52	TGAGTCATACGTGTGCCTTCACCTCTTGCGCGTGCCTCTGTGAGTGTGTATTTGTGAGATAGTGTGTACACGGAAGTCTGGAGGCCTCGATGTATCTCGGGATGGTCAGGTCTGTGAGTGTAATTTTGTGTCTGGCTTTGTCCACACTAGTCAGGTGTGTGTGACTCTGGGTGGGTCGGCAGCCATGCTGGTGACCAACCGCCTCTGGGTCTGGCGTGTCTTTCTC	TTGTCCACACTAGTCAGGTG
Target_61	AGACTGAACACTTCCTCAGGCCAGGAGATGCTTAGGGCAATTACAGACCCTCCCAGGCACTGAGGCTCCCAACCTGAAACACTCAGGCCTGAGAGCTGCTGGGTTCCTCCTCCTGCCAGTGTTCCATGGGTCCCCAGGTAAGCCAGGAATCTCTCCTTCCCAGGGCCTGTCTCCCCAGTCCACAGCAGTCAGGTGACCCCCAAAAGTCTTCAAACCTCTGTGCTGGAACATGCTAATT	CAGTCCACAGCAGTCAGGTG
Target_82	AGGATAATGGTCAGTGACACTACCTGGGCGTATATGCTCTTATAACGAGTTACTGGAAGGAGAGGAGGAGCTAGTCAATATCTCTGAAGCCACAGGAGTCAGGTGTTATCTGTAGGGGCAGATGCAGCAAAGATACTAAGGAGGTTCTGGAGTGAAGAGAGGCTTTTGTATGTG	GAAGCCACAGGAGTCAGGTG
Target_31	GCCTCAGTATTGATTGGCTGCACTGAGCAGGTGTGTGTGGTAGATAGAGGGTTGGGGAAGGCATGACAAGCACCCGGGTGGACAGGTGGACAGGTGTGTCACAGACCATCAGGTCAGTGATACTCCTTCAAAGGAAAAGATGCTTCTACCTGCATCTCACTTGAGTTTCACAGGAGTCATGTGGGATAGATGAGGCAAGGAGGACTGACCTTCTGCTGCTGAGAAAACTG	AGTTTCACAGGAGTCATGTG
Target_47	TTCTGGGTAGAAGTCTGAGTGAGTCAGAGTTATGGAGTTAATTTTAATTCATCCACAGTAGTCAGGTAGCTGGAAAATTACCTGGGCTCTGTGGCCAGAGGGCTGAACTCCAGCCTAGGTGATAGATAGATGTCTGTTCCAGCTTTTCACATGTCTTTTTTCCATTAATAGAAGCAGTGGGAAGTCAACCAG	TTCATCCACAGTAGTCAGGT
Target_18	CAACTTCATCCACGTTCACCTTGCCCCACAGGGCAGTAACGGCAGACTTCTCCTCAGGAGTCAGATGCACCATGGTGTCTGTTTGAGGTTGCTAGTGAACACAGTTGTGTCAGAAGCAAATGTAAGCAATAGATGGCTCTGCCCTGACTTTTATGCCCAG	TTCTCCTCAGGAGTCAGATG
Target_87	CGCAAGTAAGGTGCTGTGGCAGAAAACTTGGGCTTGGAGTGTGGGCCAGTTTCTGCTTTCCACAAGAGTCAAGTGGATACCACCTACTCTGGGCAGATGGAGACCAAGAAGGTTTCCTGCCCCTTGGAATGCCCGTCCTGTGAGGTGTGGCCAGTGTAACC	CTTTCCACAAGAGTCAAGTG
Target_54	ACTTTATGAGATGCTCTGAGTAGAGCCACCCATCTAAGCAGCTCTCAAATTCCTGACCCACAGAAATCAGGTGAGATAATAAGTGTTTGTTTCTTTAGTCACTTAAGTTTGGATAATTATTTATGCAGCAATAGATAAATACAGACACTAGGTAGTCTTCTGTCTTCCAGAAATTAACG	TGACCCACAGAAATCAGGTG
Target_57	CTGCTTAACTTAGATGTTAGCCTGGTACTTACATCATACAGGTTATTAGAGGTACCAGATTTTAATTCTGTCATTCAAATTTATCCACAGGCTTCAGGTGAGACCACAGGAGTTGACATCACTAAAATTCAAGTCAAGAGATGTGAGACCATGAGAGAGAAGCACATGCAGAAACAGCAGGAGAGGGAAAAATCAGTCTTGACAC	TTATCCACAGGCTTCAGGTG
Target_46	CCATCTTCTCTATTCTAGGTCCTAAATGACTTACTCATGTGGCTATCTTAGCAAGAGGATGCCGTTCACAGGCCTTTCAAGATAAAGATGACGCGATCCACAGCAGTCAGGTGGAAGCAGCCATTTATTATCAGTTATAACTCAGACATGTAGGGACATGCATTTAAAAGTCATTTTCCT	CGATCCACAGCAGTCAGGTG
Target_36	TCTGTAGGATGTCGTTGAACTGCATCATGCCCATGGGCGTCAGGCAGAAGGCGCTGCGGGCACTCCGGATCGCATTCACAAAGTCGTCGTAGTCCGCAGGAGTCAGGTGAATCAAGCGGTGGTGGATGTACTGGAGGAGGATGTGTGCAGGATGAGCCTTAGTACAAAGCACAG	TAGTCCGCAGGAGTCAGGTG
Target_66	AATATTTCAGGATCAACAATGGCAGCTATGTCTGATTCTTGCTTTACTTTAATGTTTTCAATAGCTGTGATCTTCACAGGAGTCAATTGTGTTATAATCTGCAGATGGAAATTATGAGTGCTTCTGGGCACTGTGCTACACAGAAAAAATAAAACTGAATAAAAGTACTATGATTTAATAACATAATCTCTATGAGAAAAAAATATTGTATACACCCCTAACATTTATGTGTTTCCCAAA	ATCTTCACAGGAGTCAATTG
Target_68	TTTGGCAAGGTCTGACTCACTGGGGTAGCCTCTGCCATCAGAGAAGAGATACAGAAATCCAAGTATCCATCCTAACACAGGAGCAGGAGTAGCCTTCACAGGAGTCAGCTGGTGTTGCCAGAAATGTGCAGATTTCTTTTTGGAGAGAAATTAACAAGGCTTTGTCCTTCTGGAGACCAAC	GCCTTCACAGGAGTCAGCTG
Target_03	CTGGCATCTGCTCTTCTTACCTTCTCGTGGTTGTAGTTAAAGCTTATAGCTTATGAAAGAATAGAAAATAATAAATACCAAAAAAAAGTACACATGGTAATTTGGTACCAAAATATCTCAGCTGCCTAATTTAGCAGCTCATCCCTTCCACAGGGGTCAGATGAGCTAAAGCTCCAGGTTTTATTTTTCATTTGATTGACATACAGAAAAGCCATAGCCCT	CCTTCCACAGGGGTCAGATG
Target_86	AAAACCCAATCATCTGCAGGCCAGTGCATGCTCCATCTAGGGTGGGCTCCACAGGTAGTCAGATGTGCCTGTGGTAGGTCTGAACAATGACAAACCTAGAAGCTGGAAAAATAAGCCTCTTGGGTGTTCATAAGCCATTTTAGAGTGTCTTTAAAATAGTCTCTCTAGGTATACTTACCCACTGTAGTAAGATACTATAAGTGTGCGTGTTTGTCTCCTGCGAATCTCATGTT	GCTCCACAGGTAGTCAGATG
Target_27	CTCTCAGAGGCACTTGGAAGAAGAAAAGCTTCACTATAAAGCAGCGTTACCCAACCCACACAGAGATATCAACTACTCCACAGGGATCAGGTGCATCTATCAATTCTAGCTAAACTCCACAAATAGCATACGTTACTGCTTTCCCCCACAAAACTGCCCTTGGTCCAAAGTTTGAGA	TACTCCACAGGGATCAGGTG
Target_17	CCATGAACAATACCCATCACGTAGAAAGCTGCAGAGTTTTCATTTTCACTGAACACTAGACCCACAAACTCTTCTGCAAACCTCTCCATCTCCATAGGAGACAGGTGGGAGAGTTCGTTACTGTAGGCATGGATAACCGATGCACCTCCATTAGGCTGGTGCTCTATATGAATGAGTTGT	ATCTCCATAGGAGACAGGTG
Target_32	CTGGCTTCTGCTCCTCCTCCAGGGCCAGCTTGGCAGGCAGTGGTTCATGGCGCTCCAGGACCTCCCCACAGGGGCAGGTGTGCTCAGCAAGGGCCACAGGGCCCAGGCTGGGGAAGGCATAGGCAGAGGTCCCCGGGATCCTGTGTAGGACTAGGGAGGGAG	CCTCCCCACAGGGGCAGGTG
Target_22	TACACTTGGACCCAGCTTACCCAAGGGTTTGAGAACTCCCCTACTATCTTTGGGGAGGCCCTGGCTCGAGACCTGCAAAAGTTTCCTGCTAAAGACCTAGGCTGCATCTTGCTCCTGTACATGGATGACCTTCTGCTGGGACACTCCACGGCAGTCAGGTGCGCAAAAGGGATGGATGCCCTGCTTCAGCACCTGGAGGACTGTGGGTATAA	CACTCCACGGCAGTCAGGTG
Target_39	CTTGTTGACAAACTGAGTGTGGAGTTATCCCCAACTTATGGTGGCAATGTCTGAAAAGCTTATAGGCATTTTTTGATCTCCACAGAGGTCAGGTGGGTTTTTCTTGGAAGTTTAGCATTGTTGGGCGGTGGTTAAGGGAAGAAGCAGATGACAGATCAAATCCCATGCTGTT	ATCTCCACAGAGGTCAGGTG
Target_19	ACCATGAAGCACCCAGACAGCAGGGCAGGTGCCTCCATCCACCTCTACCACAGGGAGTCAGGTGAGCCATGCCTGCTAGAGCTTCCAGCCCAACAGTCCTACTTCTGCCTGAATTTGCCAAGAGGCACAACTTCCTGTTGCCCTGGGAACACCAGGATGGCAGGGTAGGCAACTCT	TCTACCACAGGGAGTCAGGT
Target_42	TCAGTTTACAGATGAGAGAGGGCAGGATCAAGGGCTGTTTGAGGATCAACTGAGGGACAAAGGTTGACAAGCTTACCACAGGACTCAGATGGGCATGCCTCCCAGTAGGACTCTCACTGCATAGGATTGCTACCAGACCACAGCTGGGAGGGGCTGAAACTGAGACAAGGCCACCTTGGGATGTGTTGTGGGATGGAGGCTGGCAAGACTGTCTTGATGACTCAGATGAGTGTGTCTC	CTTACCACAGGACTCAGATG
Target_02	TTCAGCTGCTCTTCTCTGGGCTTTATAAGAGCTCAATCTTCCAACATTCTCCAGAGGACTCAGATGTGTGATGCTTTTCTCTGTGAAACATCCTTCACTCTAATAACTATTTGCAGCAAGTGCTGCTGTGCAAGCAGAGTAAGTGACTTGCACAAGGTCACATAGGGGAGT	TTCTCCAGAGGACTCAGATG
Target_05	GGGACCTTGAGAAGAGAAGACTACACCCATTCATTAAAGTATTACAGGAGAGCTGGCAAGATGTCTGAATAGGAACAGCTCCGGCCTGCAGCACCCAGTGAGATCAACACAGAAGTCAGGTGGTTCATGCATTTCCAACTGAGCCTCCACTGGTGATACCCAGGAAAACA	ATCAACACAGAAGTCAGGTG
Target_37	AACTTTGAGTGCATGTGTCGGTCTGGCAGAGGGTATCAAAAGCCCTGGGGAAGGCCATGGGAACAGGACAAACCTTTACTAATGCCCACCAGGCACTGTACAAGGCACTGATCCCCACAGAAGTCAGGTGAGGCAACTACTATCCATTCCCTCTTACACAGGAGGGACCTGGGACATTAAGAGGTTA	ATCCCCACAGAAGTCAGGTG
Target_51	ATATTTCCCCAATCCGAGCTTTTCCCCAAAAACTTTAGTTCACAGTTCCTATTTTGTTGATGAGTTTTACTTATGAAAAGTAAATGTACTTATGGAAAGTATAATCCACTTGAAAACTCCAACTGGAAGCTTATATAGAAAATTCTCCAGCCTTATAAACTATCAGGGGTCATCGGTGAAAATGTCCACAGGAGTGAGGTGGGTAATGTAAAAATGGGAGGAGGAAGAGCTGGACTTGAAATTCACT	ATGTCCACAGGAGTGAGGTG
Target_62	CCCTGATGAACATAGATGCTAAAATCCTCAACAAAAATACTAGCAAATCAAATCCAGCAGCACATCAAAAAGCTAATCCACAGCAATCAGGTAGGCTTTATTCCTGGGATGCAAGATTAGTTCAACCTGTACAAAACCAATAAATATGATTCATCTCATAAACAGAACTAAAATAAACCACATGAACATCTCAACAGATGCAGAAACGGCTTTCAATAAAATTCAG	TAATCCACAGCAATCAGGTA
Target_80	TGCTCATAGCAATGACAGGTATGCTCCAGGAGGGAAGGAAGAGGGGACAATATCTGACTGAAGGGCCACAGAAGCCACTGTAGGAGACTATGCAGAACTCCCCACAGGAGTCAGGTGGGTAGTCAGGGCTATCCATGGTATGGGTCTATGTTCACTTCCCTGTGGCAACAGTCTTAAGCCTCTCTGA	CTCCCCACAGGAGTCAGGTG
Target_81	AGTGGCTTTTCCGGCTTATTCTAGCTCCTGGCCTTGCCCATGGACCCCTTCCCCCCAGGGGTCAGGTGTGGACCCCTGCCCTTGGAGTCCTTCTCTCAGTCCAGTCCCAGGTCCCCCGGGGCCCTTCTCTCTTCCTAGACTGCTCCTGCCTGCCCTCTAGGGCCCCCAAGGCCTGGGAAGGAGCAGTTCAA	TTCCCCCCAGGGGTCAGGTG
Target_77	CAAAATGCCACAATGCTGAGGTTGCAAAGCCTTGTCAATAAGGAACCAGGTTATAGCAGGTGTACCCTTGCCATTGACCACAGGAACCAGGTGGGCAATGGGAATGAGTCAAACAGGATTAATGCAAAGGGGGGAAAAGGTAGTTTTTATCATCCACTTTTCCCATACTCAGGTTCTTG	TTGACCACAGGAACCAGGTG
Target_07	AGCAGAAAGACACCTTCTCTGTGCACCTTTCTTCAATGTCTCCATCCTACTCTCTGCAGCAGTGTCCTTCAGGCACCCCTCATGTTTCATTACAGCCACAGGAATCAGGTGGGTCTCTTCCACTGAACGGTGAGTGAGTGTTCTAGAAATGGATCTCGTTCATTTTGCATCACCAGGATTTTCCCTATTGTGCAGTGTTCAGGGCATGTGTTTGAG	ACAGCCACAGGAATCAGGTG
Target_53	GATGTTCTTTTGTGTTCCGTCAGCTGTACTGCCTTGAATGTTGATGTTTGGAGTTTTAAGAGAAAGAAGCTCATTCAGCTTCAACCATAACCCCTAAACCCCCGTTCCCACCTCCGTCTCTCCTCAGGAATCAGATGGAGGTGGTTCTGGGCCAGAGACAAATCTAAGGGAAAGAATTGCTGTTTCTCCTGC	CTCTCCTCAGGAATCAGATG
Target_41	CTTTCCCGGAGTTCTGGGGAATCCCCTAACCCGGGGAGCTGCAGACGACTCACTGGCCCCGGGCCGCGGTTCCGCGGGTGGCCGCTGTACGCTTGAGACACCTGGTCCGCAGAAGTCAGGTGCACGTCTGTGCACCGTCGTGCGTTGGATGTGCATGGAGGCGAGATCGTGGTTAT	TGGTCCGCAGAAGTCAGGTG
Target_76	CGGTTACTGACATTATTTGGGTTACTGTCAATTATGGTAGCTGTCTGCCTTTTCTTCTTTGGTCCTTGCTGCTCCTAAGGAAAGTCAAGCACACCCACAGGAGTTAGGTGGGTACAGGGGAGTCTACAATAGATCTATACTATTTCCTTTGAAGGATGGTCCAAATGTATTAACAG	ACACCCACAGGAGTTAGGTG
Target_15	CCATTTTTAGGCTGCTTGAGAATCACGTGTAAATTATTATTGGTATTCTAAATGACTCTGAATCACTTAAACAAAAGAAAAAAGGAAGAAAGACAACATTACCACAGGAGTCAGGTAGCTCACTGAGTTGGAGAAAAAGCTACCAACCAGAATTTTTAAAGTGCAGGAGC	ATTACCACAGGAGTCAGGTA
Target_90	GCAGCAATTGAACTGAGCACTTACTCAAAGTTTTATTGCAGACGTGTATATGTGTACACAGGAGTCAGCTGAGAAACTGATTCTCGAGATGCTTGAAGGGTTTTAAAACAGGATAAGAAAAATAACAATAATTTGTTCAATAAAGTACAGGATTGCTGGGCAC	GTGTACACAGGAGTCAGCTG
Target_84	CATGGTGATGTAGGTAACATTGGCCAATGACAGAGCAGTGCTGTTGTTGGGCATCTTGCCTTCCCAGGGGAACCTCCACAGGGACAGGTGAGCCAGCAAGATCCGTCTGTAGGGCCAGTGGGCCTAGCTCTCGCCAGACGTCTTCCCAGAGGTCCATGTGCAGTGACAGTCTAAAATT	ACCTCCACAGGGACAGGTGA
Target_08	AGTGCCACTCTAAAGACATAAAGGATGCATGGGTAGTGGTTTCCATCAGATCACCATTTAATTCATCAGCCTGTTCCCTACAGAAGTCAGATGGATCTTAACAGATCACAACTCAGCCATATCACAACACATAATCTGCTGTGCTGGAGCAGATTAACACAATATC	TTCCCTACAGAAGTCAGATG
Target_44	GAACTGCCATCAATAAACCAAGTGTGATCAGGGTGAGAAACAGGAAAGAAAGAAATATGGGGAAATGGGGTGAATGTCAGGTGGATCAGAGAGATACAGTCCATAGGGGTCAGGTGTGGCATCAGGAATAATGTGGGAGGCAGGATTGAAGTCCAGGCTAGGAACAATGGTAA	CAGTCCATAGGGGTCAGGTG
Target_89	AGGACTGAATGAGTTGCAGCCTCATTCCGTGATCTCTGATTCTTACAACAAGACTACATGATTGCCCTCACTGTGTCCATTTCATGGATGGATAAATTGAGGTCCACAGAAGTCAGGTGACCTGCTTAGGATGACATGATGAGTGAGCCACAGAGCCGGGGCTGGAACTCATACAGGGTAGAGAGCTATGGG	AGGTCCACAGAAGTCAGGTG
Target_55	TTCCTTTCTCGCTGTCGTATAGTAGGAAAAGTTTTGAGCTTACACTTTGTTCTCCAAAGGATTCAGATGTGTTTGGTCATGTACAAGTGACTCAGGAAGAGTTCACGGCAGGAGAGAGAGTTTCTAGGTGTTCAAATTGGGTCCCAGGATAATAAGTTGCCGTGAAAGACCTTGCTTATG	TTCTCCAAAGGATTCAGATG
Target_64	GAAGATGAGCTAGTTTGTTTCCTCAGGTGTGTGTGCGTGCGTGTGTGTGTGTGTGTCTGGAAAGTTCTTACCCTTTCTCCTCAGGAGTCAGGAGCCTGGGAATCAGGAGCTTAGGGCTGGGAGTTCTGCCAGAGCAAGAGCAAGATGTGGCTTGAGGCCCTTCAGAAGCCTCCCTGACTCACAGCAAGAAGCTTGGGGCCTCTTACTGATGGGTGGATGAGGTTCTTTTCTGTC	TTCTCCTCAGGAGTCAGGAG
Target_58	GTGGGCACTCACACATGGATGAAAGGGCACCACTCTGCCTATTTCCTGGCCTGCCCCTACGTGGAAGGGACCAGTTTACCAAGATGAAGAGAAATCACTCCCAGAAGTCAGGTGTACTCTGACAACAGGATGACTGACAAAAGGACCACTAATGCCCAGAGG	TCACTCCCAGAAGTCAGGTG
Target_26	CCTCCTTGAGCCTCTCTTATAACCTTGATACCAACCTGCCCAGGGCCTCACCACCAACTGCATCCACGTTCACTTTGCCCCACAGGGCATTGACAGCAGTCTTCTCCTCAGGAGTCAGATGCACCATGGTGTCTGTTTGAGGTTGCTAGTGAACACTGTTATGTCAGAAGAAAG	TTCTCCTCAGGAGTCAGATG
Target_43	ACAAAGGCTTCTTCTAGTTTCATCGCATTAAATTAATCTTTCCCAAATAGAAAGATTTAGTCACAATCAGGACTGCCATATAAGTCTAAAACAACAAACTCCACAAGAGTCAGGTGGATTCTTCCTGTTGTTTTAATGACTGGTGTAGATAAAGGTGTAAATCCTGATCAAACAGTCTG	AACTCCACAAGAGTCAGGTG
Target_70	GCAAGTTTCTAATCAACAAGAATGCATTTGGAATTCAATATTTCACCACATTAATATGATTACATGTGTTTTTCAAGGCATTATCTTAGACCTTTCAAAGATAAATAAAGCACTGTGGACAGTATAAAGAATATGCCCACAGGAGTCAGATAGGAATGGACATAAATTCCCTCTTGAGGACAGACACAATGGCTCATGTCTGTAATCC	ATGCCCACAGGAGTCAGATA
Target_56	AGATCTGAAGAGGCCCTGCAGCCAGGACCGGGAAGACTCCCCAGGAGCCAGCAGGAAGGCTCCCCAGGAGCCAGGTGGGGTCTCAGCACATGGTGGCCCAGATAAATGGCAACTAGCAGCCCCAGCATCACGTTGGCCTCTGGAACTTAGGTGCAGTGAGGAAAGGCAGGA	GGCTCCCCAGGAGCCAGGTG
Target_50	GTCAAAGTTGTTCTCCCTTCACCGTTACAAACTTGAAGTTTCCTGTTCCAGTAGGTGTGACTTCGCCTTTTGTACAATCATTTCCTACTTGCACCCAGATGTTTTATCCACAAGAGTCAGTTGAAAGACAAAGAAGGGTCTTTTCATAAAGCTTACAGAGACCCATTATAGCCC	TTATCCACAAGAGTCAGTTG
Target_12	CATCAGGATAAGATTAAGGGAGAGGCATGAATTCTGCTAAAATATAGGCATAGTTAAGTTATAACCTGCCATTGTTTTCTATCTTGCTTTTCTATAATCTCTTACTCCTCAGGAGTCAGGTAGCTGGAGTATACAAGATTTGTAACTCCCCGAATTGCTCCCATAAATAACAT	TACTCCTCAGGAGTCAGGTA
Target_73	GGGTTGGCAATAGAGTGAAGCATAGTATTATTTGTCCATGGAAGACTCTACACAGGAAGGGCTATAAGAATTATTACACAGGAGCCAGGTGTGGTCGCTCACAACTGTAATCCCACCACTTTGGGAAGCTGAGGTGGGAGAATCATTTGGGCTAAGGAGTCTGAG	TATTACACAGGAGCCAGGTG
Target_83	AGGCTATTGCTTCAACCTTAGGAGTGAAATAATTGGGAAACTCAGCGGAGTGTGGGGGAGCTAGCCAATTAGAGCAGCTAGTTCTCTATTTTCCACAGGAGTCAGTAGTTAAAGCCTCAAAGAGAAACATCAAAATTGTAAATTCAGTTATTGGAAAGATGGAGGTATACAGTATTACAAAAGAATTAGGTTAAGAATTGAGGTCATCATTTCTGTGGAAATTGGGAATGGTACTGCT	TTTTCCACAGGAGTCAGTAG
Target_09	TCCACAGAGGAGAAAGGACACGCTTGCTCTGTTCATGGAATTCTCTCCCCAGGAGTCATGTGTGTTCCTGGGGCCAGCCTGTCTTCAGAGTCTCTGCCCAGACCCCTGCTCAGGCCCCACTGATTCAGGATGGGCCGTGCTGGGAGGTGAGCAGGGCTGGGCAAGCTGAAGACGTCTC	CTCTCCCCAGGAGTCATGTG
Target_33	CAGCAATATAGACAACAGATGGACTTCCAGCAACTTCCTCTGGTGCAGCAGACAGACTTCTCTGCCTTCCAGTGGGTCACAGCCACTCCTTTCCAAGATCTAAATCTCAGCCACAGGAGTCAGGTGTGGTGGGTTCTTTTTTTGATGCTCTATCTAACTCCTAGAGATACTCATTATATCTGCCATTCTTACATGTTTTAGAATTCTATTTTTTTTATTAGCGACTACTTCGTTACTCCAATCC	TCAGCCACAGGAGTCAGGTG
Target_24	TCCAAAAGGTAATTTGCCATATATGTGTGATTCTATTTCTGGAATCCCTATCTATTCTGTTGGTCTGTGTCTGTGCTATGCCACAGTAGTCATGTGGGACTGGAATTTTCCTTACTGAGAGGGTTTTAACTATAATTGTAACTTCTTTCATTGACGTAGGATAGTTCA	TATGCCACAGTAGTCATGTG
Target_21	GCCCTTAGTAAAACAGCCCCATCTGTTTTCAATCACAAGACCCTTCCTCTCCATAGGAGTCAGATGTGATGAGTCCACTTGGGATTTGGACTAGGGTATAAATTTAAGTCAAAGGCATCATGCTGTATTCAGAGTTGCTGCTCTAAGTCTAAGGAATGAGGCTTTGTCC	CTCTCCATAGGAGTCAGATG
Target_71	TAGGCATGAGTGATGGATAGCTACTCCAGCAGTCTGCTCAGCCATCCATCTCTGCAGGAAGATGACGGTGAAAGCTGAAGAGAGTGGAGCTGACATCAGCAGAAATGACCACAGGAGTCAGATGAAAAGGCAGTGGAGGAGGGGAACTGGTCTTTAATCTGCTCTCTGG	ATGACCACAGGAGTCAGATG
Target_14	ACTGTTGGCATTGCTATCATTAGCGGTGGTGTTGGCAGTTAGGAGGTGATGGAGCAAAATTGAACAGAGTTCCCTCTAGGGGCTTCACAGAAGTCAGGTGGACTCTGTGGCCTTTGAAGTATGGGTAGAATGTAGACAGGTGCAGAGGAGTAGCAAGGACATTCA	GGCTTCACAGAAGTCAGGTG
Target_13	CTGCTCCACTCATCAGATCTTTGCCTCACTCACTGCCACCTCCCCACAGGAGTCATATGTGTTCTTTCCAAACCATCTGACTTGGGGAAACCCAGGCCATCATCTGTGCCTAAACCCCAGTTGGGAGCTGGCTTTAATTATTTCCTACTAGACTCCTGGGCTGCCATCAAACCAA	CTCCCCACAGGAGTCATATG
Target_88	GCCATCTACATGAGTAACCATCACTGGAGACAGAGGAATATTCAGATATGTCGAGGGCTGTGGTATAGAGTAATATGTGAGTTAAAACTTATTCCCAGAGATCCAAAGCACCATGAATGGGCCTCTTATTAGAGAAATCTACAGGAGTCAGGTAAGGAATGAAGTGCTGATCCAGACGTATCTCACAGTCGTTCCCTCTTT	AAATCTACAGGAGTCAGGTA
Target_28	TCTACTCTTCATGGTTGCCAGGATGTGCTGAACCAATTAAATGGCAAGTTGTGATAACTCTTAATCTTTTGGTTCTGATGCGGTCATTCCTACAATTCTACCACAGGATTCAGGTAGGTAGGTAGAGAAAGAGAGAGACACACACACACATAGAGACAGGTACTTTTCAAAATCCAGGC	TCTACCACAGGATTCAGGTA
Target_79	GTCCTGTGTTCTCTGACACTGCTAGGATCCAACGCGGACTTCCCACAGGAGGCAGGTGGGGTGAACACGGCTGCCTCTCCCTTCCTTACAGCCCTGGGCTTCCAGGCTGGGTGGCTTTGGTGGTAGACCCTGTCCCCATGGAGAAGCACTAGAAGTCTACTCCCATGAGCCTGCTCTCAGCTCCACGCACAGGTGGTGGTGGCAGGAGACCACTGACATTCTGGGAAGAG	CTTCCCACAGGAGGCAGGTG
Target_10	GACTGAGCATGTCCCATGGCAGGATGGCAGTGCAAGGCTGGGGTGTCCTTTAGGGTGGCTGGATGGGAACGAAGGGCTTCCCCTCTCCTCTCCTCAACTTCAGTTCAGAGGAACTCCACAGGCATCAGATGTGACTGCCTTAGAAACCAAGGCAGTGGCCACAGCACCAAGGAAATG	AACTCCACAGGCATCAGATG
Target_38	TAATTCTTCGTTCACCCCTGACAGTCATTTTTTTGAATACTATCCCAGCAATAAAACACCTGACCTCGAGTCTTTCAAATGGCCATTGGCTTAGGTTACCCCAATTAGCCAGACTCATTTGGAAGTATCCAGAGGAGTCAGGTGCATCACTCTTCACTAAACTCAGCATTCGGAGCAAACACATCTTT	GTATCCAGAGGAGTCAGGTG
Target_01	CTTTCTTCCTGCCTGAACTAAGCCACCGCCTCCTCTTGCATCCTGGACTAAGAGGACAGGCAGAAACCACATCCACAGGTGTCAGGTGCATCCTGGACAGTGTGACTGAGAGTCACCACCCTGGTAGGACAGTGACGGGTGTGGAGCGTAGTTCCAGAGACTGTGAC	ACATCCACAGGTGTCAGGTG
Target_75	CAGAAAGCTTCTGTTTTGCTTTTATTTGAAGATATTTCCTTTTTCACCATAGGACTCAGTGGGCTCAGAAATATCCCTTTGCAGATTCTACAAAAGGACTGTTTAGAAAACTGCTGAATCCAAAGAATGATTCAACCCTGTGAGATGAATGCACACATCACATAGAAGTTTTGCAGAATGCATC	TTTCACCATAGGACTCAGTG
Target_49	TACAGAGGAAACCCAGCCCTGCTGCCAGCAGCTGTAACTGCTCCCCCTTAGATGGTCGGAGGATCCCTGTCCTCAATTCCTGGCCCCTATTCCAGAGGAGTCATGTGCAGTGGGCAGGATCCAGGCAGCCTGGCTCTTCTGAGGGAGCTGTGCCCAGAGATACCAGG	TATTCCAGAGGAGTCATGTG
Target_16	AGGCAGAAGTGGTATGAGTTTCATGGGGGGCGGGCGGGGGGGGGTCCCTGAGCCGCAGGGGGTCCCTGAGCCACAGGAGTCAGGTGGCCTCTAGGAGCTGCAAAAAAGGACAACAGGGTTCTCGCCAGTGCACCGCCTGTTACCTGCTGGGTACTGTTCTGAGAACCCTGCATGTATGAACTCA	TGAGCCACAGGAGTCAGGTG
Target_40	CAGGATCTTACAGTCTTCAGTGCTCCTATTCCTAAGTGTTTATTGCCGTCCCTCTCTTCTCCATAGAAATCAGATGTGATCTGGCTGAGACACAGGTCTGAGAGATACACATCAATCTGCACCCTGAACTACCCCACATCTCCTGTAGCTATGGTTTCTTGTTTGCTT	TTCTCCATAGAAATCAGATG
Target_72	ATGCTGAGGCCAGATTTGAGGGAAGGGCAGGGAGGAGGGCAAGGCTGTCTCCAGAAGAGTCAGGTGTGATGGGTGATGGGTGGAGGAGACAGGAGAGGTGGGAGGGAGCAGCCTTGGGAGAGAGAGGGTGCCCTGATGTGGCAGTCAGACCGGCCTGAGATGGAATCCA	GTCTCCAGAAGAGTCAGGTG
Target_34	CCCAAACTCTACCCATCCAACATTCCTTCCTTCCTCCTCCCCTTCACAGGGGTCAGGTGTGCTCACAGTGTGGTACCTCTCACTGTCTCTTCTGGTTCCCTCCCCTTATTCCCTCCTTCCCCAACAAAAGCCATGCACATCTGATCCCATCTTGGCATCTGCTTCTTTGAAG	CCCTTCACAGGGGTCAGGTG
Target_69	GAGATCTGGCAAGATTTCTGAATAGGAACAGCTCCGGCCTGCAGCACCCAGTGAGATCAACACAGAAGTCAGGTGGTTCATGCATTTCCAACTGAGCCTCCACTGGTGATACCCAGGCAAACAGGGTCTGGAGTGGACCTCCAGCAAACTCGAGAAAACCTGCA	ATCAACACAGAAGTCAGGTG
Target_74	GGTAAGGGTGCATAAATGACCACTAAATAATGAATATGCTGTACTTCACTCCATTTTATCTGGGTTCTTTCTTATAACAATAGATGTATTTACAGAGAGAGCAACTGAGGTAAAGTGAGATTGAATGACTCGGCCTCACTTACCCAGCTCACAGGATTCAGGTGGGCTCTCGTCCTTTGGAGGACACTATTCCTCACATTCTTAAATGTTAGTGCAGAACTGTCTTTGTGGGAATC	CAGCTCACAGGATTCAGGTG
Target_67	TTGGTGCAGAGAGGCTAGAACTCAAATACTGAAGTACAGTAAAATGTCATCTTATTCTCCAGAGGAGTCAGGGGATAGAGTTGGGACTGTCAGAGCTGCTGGAAATTGAGAGGAGAAATTTCAGAAAGGAGAGATCTACAGAAGAGAACATATAAACTCCTCACAACCACTTGGCTGAA	TTCTCCAGAGGAGTCAGGGG
Target_45	AGCCTGGCCAAGATTTTTCTCTGAGCTGTACTCCAGGAGCAGGCTCACTTACCAATCATCCTTCTTCCCTCTCTCCCTCCACAGGTGTCAGATGTGTACCGTGTTCTGAAGACTCTCCCCACCTTCTCCAGCACCCTCCCCCTTTGTCCTTCACAGGCATTTCCTCCAATCAGTCTTTCGTCTTCTGCTTCATGGAAGACCTGACGGACACAGACAACTCAT	CCCTCCACAGGTGTCAGATG
Target_23	CTCTCTGCTTTATAGTGACACTTAACACAGGTGGGACTTCTCTAGGGTTGCTTGGGCCACAAGGTCTTTCAGAGCCCTTAGCAAAATAACCCTTCTGTTTTCAATCACAAGACCCTTCTTCTCCATAGGAGTCAGATGTGATGACTCCATTTGGGATTTGGACTGGGGTATAAGTTTGAGTCAAAGACCTGTTGTAATCACAGTTTTTGCTCTAAGTCTAAGGAATGAGGTTTTGTC	TTCTCCATAGGAGTCAGATG
Target_04	TAGACCAGATACCACAATTAGCTTTTGTCTTCTTAGTCCCCAGTGGACTGAAACCCTTACTCTTTCTTTACCACAGGAGTCATGTGGGTGATTCTTTCTTCCTCTTTCTCCTCCTGTTTTTTTTCCTTTTCTTTCCTCAAAGAGAAAACTAGGAAGAGAATAATGAGGATTGATTAATGGTCAGGGGAATACAATTC	TTTACCACAGGAGTCATGTG
Target_20	AGATGACAAATGTCAGGCATTCCTGCCAGATGGCCAGGACCCAGACTTGAGTGGTCACCACAGAAATCAGGTGGGAGAGAAATTTGAGAGGCACCACTAAGGAGAATAATCAGAGTGTGGTGGTTAAGAAGTAAGTATAAGACAGGATGATAAGGTTTGGAGTCTGGGACCTCAAAAAAAGGAGAGAATGAAGGCTTACAGCCTGGGTGAAGCATTAGACCTAGGGAT	GTCACCACAGAAATCAGGTG
