MKSR_Target01	TGATTTTCTGCAAAAGCCTCAGCATGAGAGGAGGAGGCAGCTAATGGGAGGTTTGAGTCAATGCCCCACAGGACTCAGGTGAACTTACTCTTTAAAAATGTAAATCCCTCTGGACAAAGGGCAGTCTCCATGCAAACCAGGCACGTGGGCTAGACATCAGAGCAGGAGCTCTGTTCTGAGTTACCTGC	TGCCCCACAGGACTCAGGTG
MKSR_Target02	TCCTGGCTATTGACACTAGATTGGCATTACTCCCAAAGGTCAGATTCTCTACCTGCCACTGTATGGCATTTCTCCATGGGAGTCAGATGCACTCAAATGTACTTTTCCACCAATCATTGAGTCTGCTCAGAGCACATCATGAACTAAGCTAATGCTTTTGCCAGAATGTTCAACTTTTC	TTCTCCATGGGAGTCAGATG
MKSR_Target03	CATGCCCAGTTTCTATTGGTCTCCTTAAACCTGTCTTGTAACCTTGATACCAACCTGCCCAGGGCCTCACCACCAACTTCATCCACGTTCACCTTGCCCCACAGGGCAGTAACGGCAGACTTCTCCTCAGGAGTCAGATGCACCATGGTGTCTGTTTGAGGTTGCTAGTGAACACAGTTGTG	TTCTCCTCAGGAGTCAGATG
MKSR_Target05	CTTGAAAGCAGTCAGTTACAAAAAGGTAGTTGTGGTCAAGTAGTTTTAATATGTAAATTTGCAAGTTTTTGGAGAACCCCCAAACTCCTTCTCCACTGGAGTTAGGAGGGCCTGTGGTAGACAGCGTGAATCATGAAAATAAGCCTGGAGAGTTCTGTTATTAAGGGGCATAG	TTCTCCACTGGAGTTAGGAG
MKSR_Target06	TCCTGGGTCAGGAGAAGACCTGGAAAGGGAAGGGGATTATCTGCAGTTTGTAGATTTTCTCCACAGGAGACAGCTTTGCAGGGCCATTTCAAAATATGTCAAAAAATATATTTGGGGATAAAATACTTCAACTTCTTTCGGGGCCTGTTACCTGTTGTGT	TTCTCCACAGGAGACAGCTT
MKSR_Target07	CTGCATGTATCAATTTTGAGAGAATTCAGTTGTATACAATATTAAGTCTGACAGTTCACCAACATGGTATCATCTTTCATTTATTTAGCTCTTTAATTTTTCTTAAAGTCTAGTTTTCTCCCTAGGAGTCATGTGTACCTTATCAGGTACTCAAGGTACACGGTATTTTAAATTCTACTGTAAATGCTATTTAATTTTTTTTTTTTTGAGACAAGGTCTCACTCTCACCCAAGC	TTCTCCCTAGGAGTCATGTG
MKSR_Target08	CCACTTGCCAGCTCACAGGAAATGCCCGCTTGAGCTATTCTCCAAAGGAGTCAGAGGAACATCAAAAGGGACAGCCAGTCAGCTGGTATATACATATGCACCAACATGAATAACCTACAGTTGCAAAAACAGAGGCTTGAAGGGAAACTGGCTGCTTGTCTG	TTCTCCAAAGGAGTCAGAGG
MKSR_Target09	AGATCCTGAAAAATGCCCAAGCCCTTCCTAGCCTTTTTTTTTTTTCAGGAAATAGAGTCACAGGAATCTGTATTGTCAAGTTCTCCACATGACTGAGGTGTGCATGCAGATTTTGGAAATCACTGAATTAATAACACTATTCCTATAACATCATCATTTTTATTAGAGGCAGGATCTTACTCTGTTACCCA	TTCTCCACATGACTGAGGTG
MKSR_Target100	CTGATCTACTTGAAGCCACACTGATCTGGGAGGGCCCTATAAGAGAAATAAAACCTCAATATTCTCCACAGAAATAAAATGGGCCATCTCTCAGAGATACATCTTTCAGTCCTCAGGAAGGCTACAATAGAAGGACAACAAGCTTTATCTACCAGCTGCCAATATATGGAAAG	TTCTCCACAGAAATAAAATG
MKSR_Target101	GCTTTGCAACTCTATCATGGAGCATCAGAAATGACTATTGTTTCCAGTGCATCATTTTCGCTAAAAGTGATCCTTGCTATGAAAATGAAATGAGTAAACCTAGCTTGATTCTCCAGAGAAGTCAAGGAGACCTGAAGGTTAGAAGGATTTCTGACATTCAGCCCACATGAGTG	TTCTCCAGAGAAGTCAAGGA
MKSR_Target102	GTTAAAATGTCCATACTGCCCAAAACAATCTATATATTCAATGCAACCCCTATAAAAATACCAATGACATTCTTCACAGAAATCAAAAAAGCAACCCTAAAATTTATATGGAACCACAAAAGACCCAGAAGAGCCAAAGCTAACATGAACAAAAAGAATGAAACATCACCTGACTTCAAATTATACTATAGAACAATAGTAAGCAAAATACCATTGGCGTAATCCC	TTCTTCACAGAAATCAAAAA
MKSR_Target103	CAATTAGTGGGAGTGAAAAACCAACTTGAGAAATAAATCTGTAAGTGAATGCTACTGGTTCTCAAAGGCATCTTCTTGACAAGAATCAAATGAACACTATCTCTAAAAATCCAATCTGAAGGCAAAACAGATTTGTTAGTGTGATTATTAAAATAATTGCCACCTTCTGGTGTAAAGTGATGTCAACAGTGAA	TTCTTGACAAGAATCAAATG
MKSR_Target104	GTGGGCAAGTTATAGGGAGTGAGAAAAGAGAATGCTGTTCAATTGAATTGCACCTGCTCCACAGAAATGAAATATACATAGATTAAGTGTTTTAATTTTTGTTATATAATAAAAATCTCATTTTTCCTTTTAATCTACTGGAAAGATATCACCATGGTTAACAGTTTTGCCAC	TGCTCCACAGAAATGAAATA
MKSR_Target105	GCTCCTAAAATAAGATGCCCACGATTCCAAAATATTTTATTTCTTCACAGATATCAGATAAACAAACAGAAAATTTATTGCAAAAAAACCTAAACCACCACCATAACAACAAAATGCAAAATACATCAACAAACAAAAACTTGCTAAAAAGAATAATTTCTCTTTTAAAAATACCTAGGCAGCAAATAGGAAGGTGTGAAA	TTCTTCACAGATATCAGATA
MKSR_Target106	ACAAACTTTCTTAGAACTGCCTTCTTCCACTCAATCCTCTCTCCCTCTGTCCTCCACAAGGGTCAGATGAGCATCTTTGTTTGAGAGCTCTCCAAGGCTTTCCTGGTTCTCTCCCAATTTTCCTTCATAGACATTTTCCCTAATAAATCTATTGCCCATCTAATCCTGTCTTGGCATCTGCTTTTCTGAGAAACTGCAGTAGCACATGTGTGTTGGCACAAGTCAATTCATGGAGT	TCCTCCACAAGGGTCAGATG
MKSR_Target107	GTGCTTAATAACTGCATGTGACTCTTGGAAACCATATTGGACAGCAAAGATATAGAATATTTCCATTATTGCAGAGAAAGTTATATTTAACAGCAGTGGAACTCTTCACAGAAATCAAATACACATTTAGATTCCTTCAATATCCCCAGAATTAGATTAGCTAGCTTTTCTTAGGAAAACAG	CTCTTCACAGAAATCAAATA
MKSR_Target108	GTCCATACTATCCAAAGCAATCTACAGATTTAATGCAATCCCTATCAAAATACCAATGACATTCTTCACAGAAATCAGAAAAACAATCCTAAAATGTATATAGAACCATAAAATACCCTGAATAGCCAAAGCTATTCTAAGCAAGATGAACAAAACTGGAGGAATCA	TTCTTCACAGAAATCAGAAA
MKSR_Target109	GATCCTTTTAGGCCTACTGAATAGATCAAGTAATTAAATAACTATCTAGCCTGTGTTGTTATTGTCTGTTTTCCACAGAAATAAAATATACAGCTGAAGGCAAATAACAAATATATCCAATATATATTAGTTTTAAGTCTCTTCAGATTTACTTAGGCTCCCAATTAATAAGAC	TTTTCCACAGAAATAAAATA
MKSR_Target10	GCCTTAAGATGTGCCAGACTCTTAGTTAATTCTTTCCTGGATCAGGAAAAAACTTGCAAAGGAGAGGGGGTTCTCTACAGAATATAGATTTTCTCCACAGGAGACAGCTTTGCAAGGCCATTTAAAAATATGTCAGGCCGGGCACAGTGGTTCACACCTGTAATCCCAGCATTTTGGGAGGCCAAGGCAGTGGATCACTTGAGGTCA	TTCTCCACAGGAGACAGCTT
MKSR_Target110	CAGACTCTTAATCTCTCCTGAATCAGGAAAAGTCCTGGAAAAGGAAGAGATTCTCTATAGAATGTAGATTTTTCTCCACAAGAGACAGATTTGCAGAGCCATTTAAAAATGTGTCAAAAATATATTTTGGGGTAAAGTACTTGAATTTCTTTCAGGGCCTGCTATCTGTCATGTGATGCTACA	TTCTCCACAAGAGACAGATT
MKSR_Target111	GTGAAGCAGGAAGGCAATAATCAGATGACTATGTAATATAAAGTTAGCTAGCGGTTACAGCTTGGAAGAAAAGTTAGTTTCCACAAGAATCAAATGGGCACTTGTTTAAAATGCAGATACGTGAGTCCACCCACACTGAACTGGAGTATTCATTCTAACACCTCACACTGTAACCTGGAAAGTG	GTTTCCACAAGAATCAAATG
MKSR_Target112	ATGAGGCCTGCATCATTATAATACCAAAATCAGGCAGAGATAAAACAAAAAAAGAAAACTTCAGGCCAATATCTTTGATGAACATTGATGCAAAAATCCTCAACAAAATACTGGCAAAGCAAATCCAGCAGCATATCAAAAAGTTATCCACCAAAATCAAATAGGCTTTACCCCTGGGATGCAAGGTTGGCTCAACATACACAAATCCAT	TTATCCACCAAAATCAAATA
MKSR_Target113	ATCTCTGAATGCGTAATCGACCAGTCATCTTGACTTAAATTAGAATAACTTAATGCAAATTAACTCAGTATATATTTTGCATATTGATCAATGTTCTTTTCTCCTGAAAAGTCAAATAAACAAGGGAATTTCCGAGGTTACCTGTGCACCTTCTATCACTCAT	TTCTCCTGAAAAGTCAAATA
MKSR_Target114	TTTAGACCAATCTCCTTGACCAACATTGATGCAAAAATCCTCAGTAAAATACTGGCAAACCGAATCCAGCAGCACATCAAAAAGTTTATCCACCAAAATCAAGTGGGCTTCATCCCTGGGATGCAAGGCTGGTTCAAAATACACAAATCAATAAATGTAATCCAGCATATAAACAGAACCAAAGACAAAAACCACATGATTATCTCAATAGATGCAGAAAAGGCCTTTGACAAAATTCAACAATGC	TTATCCACCAAAATCAAGTG
MKSR_Target115	GTGAAAGTGCATTATTGAAAACCAGAGATTAGTTTTAATCATCAGTTGTCCACAAAAGTCAGAAAAACAATTTTTTAAAATAATGAGTTATTATGTAAAAAGGTCAAGTCAATTATAACTTTTTAAATATCATCCACTCTCAAGTTCAGTGTAGACTTGAATCCTAGTGAAG	TTGTCCACAAAAGTCAGAAA
MKSR_Target116	AAAGCACTGGCAAACCAAGTCCAGCAGCACATCAAAAAGCTTGTCCACCAAAATCAAGTAGGCTTTATCCCCAGGATGCAAAGTTGGTTCAACAATAGCAAAGATATGGAACCAACCTAACTGTCCATCAACAGATGACTTTTGTACCAGTACCATGCTGTCTCAG	TTGTCCACCAAAATCAAGTA
MKSR_Target117	CTGTGTGTGTGTCTTTAATTCCTCTAGCGCCGCTGGGTTAGGGTCTGCCCGACCGAGCTGGTCTCGGCACTCTCAGGCAGCCTTTGACTCGTGCGAACTTGTTTATAAAGTCCTCTTTTCAACAAAAGTCAAGTACACAACTCCTCCCAAATTCTGGTTTCTAAGGAGAGACTCCAAAGAAGTC	TTTTCAACAAAAGTCAAGTA
MKSR_Target119	AGCGTTCCATCTCAGGATTTTCACGGGGAATTTCAAGAACCAAGGGGGCCTCTGAGATCCCCAGAACCTCTCCTTTCCACGAGGCAGCTTCCTTCCTTCCCTGCTCGTTCTCCACAAAAATCAGGGCTGCCCGGATCCCAGCAGTGAGCGCTGCTCTCTTTGGCTGCTGTATCCC	TTCTCCACAAAAATCAGGGC
MKSR_Target11	GTTGAGCTTAACTGACCAAGAGAGACTAATAGGATTTTAGCTTTTCTGGGAATGTCACTCCATAGAAATTTTCATGTGTAGTGTGATATGTCCACAGGAGACAGGTGGGCATCCAGTACAGTACCTACAACTGTGGAGTGGCTGCGGGAGGGCTAGTGGATAGGGAAGACAGTGTAG	ATGTCCACAGGAGACAGGTG
MKSR_Target120	CAAAGGTAGAGTTCTGTTTCAGACCCAGGTCTCTGATTCCAAATGCTTGGCTGCGTCTGCCACCCATCCTCTTTCCACAGAAGAATCTGGTTCTCCACAGAAACCAGGAAGGCCTGCAGAGCCGGAGGGCATGCTGTGGTTGCCGTCTTTCATCCCAGCCTGAAACAGATCCTTTTGGAAG	TTCTCCACAGAAACCAGGAA
MKSR_Target121	ACAGCCAGCATCTTCAAATTGTCTGGCTTCTCAGGAGTCCTTCTTGATTGATTCTCCCCAAGAATCAAACACACTTCTTTGTCAGGTCTCTCTGCACTCAAATACTTAAACTGAAGGTTACTTATTTGCATTTTAAAGTTACTGGGGCCTTTAGGAACACCTTGAGTTTGGGCTGCACCTCTCTGGATTCACTGTGGCTTT	TTCTCCCCAAGAATCAAACA
MKSR_Target122	TCAGGCCAATATACCTGGTTAACATTGATGCGAAAATCCTCAATAAAATAAACCAATTCCAGCAGCACATCAAAAAGCTTATCCACAAAGATCAAGTAAGCTTCATCCCTGGGATGAAAGGCTGGTTCAACATACACAAATCAATAAACATAATCCATCACATAAGCAGAACCAATGAC	TTATCCACAAAGATCAAGTA
MKSR_Target123	GCTTCTGTTCTTGGTATTACTCCCATTGGTTTTCTTTTTTAAAATATATTGATTAAATTAATCCAGGTCTTGGAATAACATATTCTGCACAGAAATCAAAGAGACAGAAAAAGTGATAAATAATTGATGCAGCCTCTGATATGTTAAACATGCAATGTTGAAAGAAAATTTTTCTCCTTTGACATACGGTAAGTCTGAG	TTCTGCACAGAAATCAAAGA
MKSR_Target124	TACCGCTAAGAATACGGAAACAGTGTTGAATAACATACACTAAAATGAGGGTAGATAAATGGAATGCCCACAATCAGGGAACAAGCTTCTCTTCTCCATTGAAATCAGATGGACCTGGCTCCAGATAACTGTATATTTTACATGTGAGCCTTGTGACTTTGGGAAGTTAATTAGGCAGCCAAAAC	TTCTCCATTGAAATCAGATG
MKSR_Target125	CCTTCCTGCTTTCTTCTTATCTCTTCCCATCCATTGTGAACCTTTCTTCACAAAAGCCAGATGTACCTTTTGCTATGGCCTGAATGTTTGCATCTCCCCAAAATTCATATGTTGAAATCCTTACCACCAAGGTGGTAGTATTATGAGGTGGGGCCTTTGGGAGTTTATAAGGTCATGGGG	TTCTTCACAAAAGCCAGATG
MKSR_Target126	CTCTACCTCAGCTGAATACACCCTTGGACCCAAAGTCATCTCTTACTCTTAACTCCTTCAGCATAGGCCAGGGCCGAACAGAGTGCTACTCCACACCCCTCCTTCTCCAGAAACATCAGGTAGGCCAGCAGGAAGCCCTTCTCCATGACAGGTAGGGCTGTATT	TTCTCCAGAAACATCAGGTA
MKSR_Target127	AAGTATATTTTCTACAAATTGTACATTGCCGTGTCCTACAAAACCAAAGATTGTTTACTTTCAGAAACTTTAAACACTGCTTTAAATGCATAGAGTTCTCCACAAAAATGAGATTAGCAGCTTCAGTACTGCAGTGTAGCAATATTATCAAAATTATTACAGAAATCAATAATACTTTCATTTCCAGAAC	TTCTCCACAAAAATGAGATT
MKSR_Target128	TTTAATTAGTCTGGGTTGAAGCTGAGCATCTGTGTTATATTTTAAAGTTCTCCAAAGGAGTCTAATGTGCAAGAAGTTTTGAGACATGCAGGATCAGACCAATCTTACAAGCAAGACTGGGCAGTAGAATAGGGAACCTCTGGCCCCACCCACTTCCTTGGGCCTCATGCTCCCACGTAGCTTCACATCCCCAAAACAGAAATTGGAAGACACAATACAGAGG	TTCTCCAAAGGAGTCTAATG
MKSR_Target129	CACAAAAGTGGTACTCAGTACTCTTGCAATTTTGTCTATCTTCTTACATTTTGTGGTTGTTGTTGATTTATTGTTAAATGTCCCTTTAGCAGAAATTGATATTAGGGCTTCAACACAAGAGTCAGGTAGACTGCAGGATAGGTGTTCATCTTAAATGGGCCAATGTTGAGAAGAGTTGC	TTCAACACAAGAGTCAGGTA
MKSR_Target12	ATCTCTGCTCAATGCCAGTCTCTGAATTACATTCTCTGCTAAAACTGATCCTGCATTGCCTTGAATTCCCCACAGGGGACAGGTGTACTTCCCAGCATTGGATGTATCCTTGGGCAAGGATACATCGAGACAAACCTTTCTTCTTTCCAAACTCTCAGGCACCCAA	TTCCCCACAGGGGACAGGTG
MKSR_Target130	TCTGCCAGTTGACCTACCCAACGGGTTTCCCTAACAAAATCTCAGGAAGCAGGGGCTGGGGTCTCAACCCCTCCTACTCTGAAGGCTCTTGATTCAGGCAAATTCTCCACAAGAATCAGCTCTGCAGGCTTAGCAGCCCCATTGAAGCTGCCAGGTATGCAAGGA	TTCTCCACAAGAATCAGCTC
MKSR_Target131	AGGATACAGCAATAAGGCGTGATGGCTGCCTGAAAAATCAGGATGTGTTTTCTCCCCAGGAATCAAATCAACCAGCACCTTGATCTTGGACTTCTCAGCCTCCAAACTGTGGGAAATAAATTTCTATTGTCTAAGCCACCTAGACTGGTATTTTGTTAGGAGTATTTTACTTTGGTACCAAGGATGGTGTGCTGCCATAAGCAAATATCTAAAAATGTGGAAGTGGCTTTGAAACTGGAT	TTCTCCCCAGGAATCAAATC
MKSR_Target132	CATTCATGCACTTTTCCTCATTACCTAGGTATGTTTTATTTCACAAAATTAAGAAATTGATAAATTAAATGTTATCAAAGAAGACATAGTAAAACAACAAAAATAAATTTTAAAATATTACATTGAGGATGTGGAGCCTTCCAGTTCCAAAATATTAATGTAGAAGCAAGCTAGTTTCTTTCTACTCCACAGAAAACAAATATACAGCAGCAGTATTATCACCAGCAATATCCAAGAACTCAAATG	TACTCCACAGAAAACAAATA
MKSR_Target133	ATTCCATGCTCATGGACAGGAAGAATCAATATTGTGAAAATGGCCATACTGTCCAAGGTAATTTATAGATTCAGTGTCATCCCCATCAACCTACCAATGACTTTCTCCACAGAATTCAAAAAAACTGTTTTAAAGTTCATACAAAACCAAAAAAGAGCCCACGCTGCCAAGACAATCCTAAGC	TTCTCCACAGAATTCAAAAA
MKSR_Target134	GGTATCTCCATGAATGACACCCTTTCATTCAGGGTCCTCTCCTGCTCATAGTTCTGGAGGTGGTGATGATAGTTGAGATAGTACAATAATGAACATCAGAATTAATCAATGCTCCTTATTGTCCACAGAATTCAGATGAGCCTTCCTTAAGTCTTCAGAGCAAAGCCTGCTTAATGCCTGTTTAAACCT	TTGTCCACAGAATTCAGATG
MKSR_Target135	AAGAACACCTTGTACTCTTTTTCAGACTGAATTTTACGGGGCTCTAACTACGCAGTAGGCTCTGTAGTATGCAAGGTCAGAGCCTAGCTTCTTTATTCCTGTCCTCCTCAAAAGTCAGATAGACAGAAACTATTATCCTCATTTTATTGAGAAAGAATCACCCAAATTTATACGACAGTCAG	TCCTCCTCAAAAGTCAGATA
MKSR_Target136	TCATTTGCCTCAACATGGATAGACCTGGAGGACATTATGCTAAGTGAAATAATCCAGACATAAAAAGAAAAATATGGCATCATCTCACTCAAAAGTGGATTCTACAAAAAAATCAAATATACAGAGATAGAGTAATAGTGATTACCAGGGGTGAGGTGGAGCGGGGTGGGATATGGGGAGAAGTGGGTTAA	TTCTACAAAAAAATCAAATA
MKSR_Target137	GAGATCTTCATTGCCAAAAGCAGTGTTATGAATAAAGTTAACCTTGGAAATTAAATTTTAATCATTTTTGCATTGCCAGTTAACATTTCTAAGAATAGAATAACCAAGTTTTCTTCACATAAATCAAGTGTACACATTCTCCTAGATTTTCTTCAAATCTCTATGTTTGCCCTTTTTCTGTGC	TTCTTCACATAAATCAAGTG
MKSR_Target138	GGCTTGGCTTAGTTTATGCAAATTGCTTACACATGCAAATTTTCCCCACAAAAGTCAGGTTTGCAGGGCTACCTCTTCTTGCTGGCTCTGTTTATATAATCTCCAATTATGTCAAGGAAATATATTTTGGGCTTTTTTTTTCCTTCCTTATGATATTCTAAATTATGGGAACTTTCCTGCTGAACTAGAG	TTCCCCACAAAAGTCAGGTT
MKSR_Target139	GAGACACAACCGAGAAAGAACTTTCGGCCAATGTTCTTGATGAACATCAATGCAAAAATCCTCAACAAAATACCAGAAAACCAAATCCAGCAGCACATGAAGAAGCTTATCCACCAAAATCAAGTAAGCTTTGTTCCTAGTATGCAAGTTTGGTTCACCATATGC	TTATCCACCAAAATCAAGTA
MKSR_Target13	GCTACCTGAACAAAACTGGGCTTCTGTTAGTGTGGAGGAAGTGAGCAATAGATTTTGAGTGTAACAGCCAACATTCCCCACTGCAGTCAGGTGTACAAAGTGAGAATGGCAGCCCAAATCTAAGGAACAGCTGCTCAGAGACAAGGAGGCATAAAGGACCT	TTCCCCACTGCAGTCAGGTG
MKSR_Target140	GAAAACACCTGGCTAGATTAGTGGAGATTTTCTACAAATACAAATTATTCTCCACAAAAGTCAGCTTTGCAAGGCCACTTCTCTTTGCTGGCTCTGCAGCAGCCATTTCAAAATATGTCAAAGAAATATATTTTAGGGTAAAATGTTTTAAATTCCTTCAAAGCTAAATAAAATTATGATCAGCGAATTTATTTTGTATGATTTTAACTCTTCGAATTTGTTGAGACTTGCTTTATGGC	TTCTCCACAAAAGTCAGCTT
MKSR_Target14	CACTCTGTTGGAAGGAGACCTTGTTGCCCTGAGAATCCCGGGGCCAAGGACGGGACTCAGCAGGGAATTTTCTCCCCAGGAGCCAGGTGGGCATCTGCAGGTGTTTGCCTGCAGGGACTTGGCTAAAAGGAGCCATTGAGAGGTTGGGTTAATTGGCATCTTC	TTCTCCCCAGGAGCCAGGTG
MKSR_Target15	CCAGCTTGGGTGACAAAACAAGACTCCATCTCAAAAGAAAAAAAAAACAGCACCAATGAAGCCTAGTTCTCCACGGGAGTGGGGTGAGCAGGAGCACTGCACATCGCCCCAGTGGACCCTCTGGTCTTTGTCTGCAGTGGCATTCCAAGGCTGGGCCCTGGCAAGGGCACCCGTGGCTGTCTCTTCATTTGCAGACCCTGATCAG	TTCTCCACGGGAGTGGGGTG
MKSR_Target16	GCTAAGGCCATTCTTGCTTTAACCACTACCAAAATTCAAGATTACCATCATGCTTAAGGACCAGAGTGTTCTCCAGAGAAGTCTGGTGAGCCCTCGTCTGTGCTGCCTGCTACCAAGTTTGACCCATAACAGCACTAGGTTATGGGAGTGATGAGTTGGAAAGAAAGTAGGGAGAGAC	TTCTCCAGAGAAGTCTGGTG
MKSR_Target17	GTAATCTTAGTTCCTCTTCTACTCAGTACAAACTTTAATAACTAAGCCAAGAAATGAAAAATAAAGTTCTCCACAGAAGTTAGCTGAACTAATACAGAGAAATTAAACATCAAATGTGTGTTAAAAAATCACAAAGATGATCATTACTAAGGATTCAAATCAATGGAAAAAGTTTTTAGAACTGTTTACTTGTCAGAGATTCATATATTTACAAGTGTTACTTCAGGCC	TTCTCCACAGAAGTTAGCTG
MKSR_Target18	AGAGTTTGGTGATGCTCTCCAACATTTAAAATTTAAAAAGCTAAAAATTATGTTCTACAGGTAAATTTCTTCACAGTAGTCAAGTGAACATTTTAAAATTCATTCATTTTAGTGGGGCCTGAATTTCTCTAAAAACTACACTGATTGACAATGTGTACCTTTTTAGATCAAATCATCTCTTTTATATTAAACAATGCAATTTGGCATCTCAACTTGCTACCTTCA	TTCTTCACAGTAGTCAAGTG
MKSR_Target19	GCAAGTAAGGTATCCGGTCTGCCATATTGCCAAAAGTATATCTTTTTCTTCTCCACAATAGTCAGGAGGGCAGGAATTTCTATTTCTTCACAGAAGAGTGACCTGAAGCTCAGAGAGGGTGTAGCCATAGGCCTAGCAGGTGAAAGGCTGGGAGAGAATA	TTCTCCACAATAGTCAGGAG
MKSR_Target20	TAGGCTGCATCTTGCTCCTGTACGTGGACAACCTTCTGCTGGGACACTCCACAGCAGTCAGGTGTGCTAAAGGGACGGATGCCCTGCTTTGGCACCTGGAGGACTGTGGGTATAAGGTGTCCAAGAAGAAAGCTCAGATCTGCTGACAGCACAGGCACGATCCCACTACTGATCAGCACGGGAGTTTTGAC	CACTCCACAGCAGTCAGGTG
MKSR_Target21	GGTTCTTTCTTGCCCAACCCTGCTTCCTTCCCCCTCTTCTCCACAGGAGTCAGACCTGCACCACGATCTGCAGGCTCTTTTTGTCTTCCCCAGCTCCTTCCCCTACTCCCTTTATGGGTAGTTCCTCCAATTAAACTCTTCTACAGCTAATCCCATCTTGGCATCTGCATCAG	TTCTCCACAGGAGTCAGACC
MKSR_Target22	CAAATGTTTTCTGGATTCACATGTAAAGAGACAATGGGATCTACTATGGAGAGTTGCTCTCAGTCCATCTAATTTACAGAGCAGCAATTCTCCAGAGGATTCAGCTGTACTTCTAACTGCTCAAATGGAAGGTTATCTTAACATCAGCTCACAGACAAAAATTGAACTTATGGATTC	TTCTCCAGAGGATTCAGCTG
MKSR_Target24	CACCTGAACCAATGACAAGTAAGTTGAAAACTGGATTGTATTAGGTTGCTGCAAAAGTAATTGTGGTTTTTGCAATTAAAATACTAACTTTGAATACAGCAGTTTCTCAGCAGGAGGCAGGTGAGCCAGAACCTTCCTTACCAGGGAGGAGGTGGCTGTGAACTGAACCTTGAAGTTGAACCTGAGGAG	TTCTCAGCAGGAGGCAGGTG
MKSR_Target25	GCTCCAAACACCCTTCACCCATCTTTGGCCCAAAGTCCAGGATGCCAGCCCGAGGCCCAGAGCCGCGCCTTCTCCACAGGAGACTGGGGCACCCCGGACAGACGTCCCCGTGTGGTGGCACCTGCCCGGGCTCCTTCTTGCCTCCCCTCTCGGGAGGAGAGCCCCTGCCACCCACCCCACCTCCTCCCGCTACGACCTCAGCACGA	TTCTCCACAGGAGACTGGGG
MKSR_Target27	AGAATGACAAAGCACAGTGTTGGACAGGGATTGAGAAGTCAGGCACTGTTGGGCACATGCCAAAGATCAAACAGCTTGGAATGAGGGGACCAAAATAGGATTTCAGGTCTTTCTGTCTCCACAGCAGGCAGGTGTGCTCTCTCCAACATTCATCACTCCCTCCTGGACTTGGAATTTAGAC	GTCTCCACAGCAGGCAGGTG
MKSR_Target28	AGCTAAAGACTAACTTGGATGAAATTTTCAGGAACTAAGCATAGTCAAAAAGAGATATATTTTGTCTTTGGGTATGTTTTGGGGAATAGGGCAACATTTTTTTAGCAGTTTTCCACAAAAGTCAGGTGTACCCAGGCTGAATTTATGGAAATGGTCTTATTTATTTTCACATCCCTGATAC	TTTTCCACAAAAGTCAGGTG
MKSR_Target29	GACCTAGGCTGCATCTTACTCCAGTACATAGACAACCTTCTGCTAGGATACTCCACAGCAGTCGGGTGTGCAAGAAGGATGGATGCCTTGCTTCGACACCTGGAGGACTGTGGGTATAAGGTGTCCAAGAAGAAAGCTCAGATCTGCAGACAGCAGGTACACTACC	TACTCCACAGCAGTCGGGTG
MKSR_Target30	CAGTCACTCAGAACAAAGTGAAGTCTTTTACAGGGGTGCAGAATCATAAGCCTGGTCCACAAGAATCAAATGGGCCAGACTTTGAATTCAGTCACCCATTTTTAGATTATCTGAGCCATCATGAAATTGTTTGTATTTGTGTACTACGGAAGATGGGGATTTGCTAATTTCAAG	TGGTCCACAAGAATCAAATG
MKSR_Target31	CCTCATAGAATAAACTTGGAAGTGTCCTCTCCCCTTCTAATTCTTTGGAAGATTTTCAGAGAGATCTGGTGTTCTTTTTAAGTGTTAAGGTAGAATTCTCCAGAGAAGTCAACTGGACTGTCTCCTTATTGGCAGGTACTTGATTATCGATTCAATCTCTTTACTAGTTATCGGTTTGTTCTGA	TTCTCCAGAGAAGTCAACTG
MKSR_Target32	CCTGCAAATTTATGTTTCTGCTGCTATGGTTAATATTAGATTGAAAAAATTTTGGAAAAAGAAATCTTATATTTTCTGAACTACATATCTAATTAGTATTTTCCTCTTTTCTCAGGTTATAGAAACATTATCACGACTTTCTCGAACACCTATAGCATTGGCCACAGGAATCAGGTAAGCTCTGTTTTCGTTGTTCATGTGTCCCATTGAGTTCAGTGTAATG	TTGGCCACAGGAATCAGGTA
MKSR_Target33	AAGTCCTGGCTGCATCAATGCAGATTCTCCACAGATATAAATTTTCTCCACAAAAGACAGATTTGCAGGACTACTTATGTTTGCTGGCTTTTTGACAGCCATCTCAAAATATGCTAAATAAATATATTTTGGGTTAAAATATTTTTATGTCTTTCAACTGGGTGGAGGG	TTCTCCACAAAAGACAGATT
MKSR_Target34	GAAACAAAGGTTCATACATTGCTCACAGATGTTGGGCAACAGGCAGTGCAGGAAAATAATTCTCCAGAGAAGGCAAATAAACAAGGTGAGTCCTGTGATTGTCGTAGATTACTGCCTAGAGAGTTTTTAGGCTTCAGTGAAGAGGGGAATCCCTTGGTCTTTCTGAGGAGACATAAATTTAGAGTGTGGG	TTCTCCAGAGAAGGCAAATA
MKSR_Target35	GTTTCATGAAAGCCCCTATCAGGAAGTAAATGCTAGGAGGTTGATCCTTATTGGGTTTCAGCACAAGAATCAGATGAGCCTCCTGTTAGATATGAAATCTGCTCCAAGTATTGGAGGATATGTTAAAAAAAACAAAACATAGAATAGTATTCCAGGCTGAAGAAATAGTGTG	TTCAGCACAAGAATCAGATG
MKSR_Target36	AATTCATTGCATCCCAGAGCTCTCTCTTCCCTAGTTCTTTGTCTCCTCTTGAGGATTGTACATTTTTTCTAAGAACTCATCTTCAGTGGGAGTTTTTTCCACAGGCATCAAGTGCACTGGTTTGTGGAGGTTTCTTGTGACAAGGGGCACATTTCATTCTACCAAGGG	TTTTCCACAGGCATCAAGTG
MKSR_Target37	CATCTCCAACACGGAATACTGCACACACCTTTTTTTTCTATTTAAAATTTTTAACTACTTATACATAACAAAGAAATATATTGTTCTCCCCAGGTATCAAATATACATACACTTTTAAAATAATTTATGAAAATTTTAAAGCAGGAGGAAACATGAAACCCTGCCA	TTCTCCCCAGGTATCAAATA
MKSR_Target38	CTCTATCACTAACTTCTTGGATGTATGTTAAGTGTGCAGATAGGCTTTCTCCCCAGGAGTCAAATTAACCCCAACTTTACCCATGCTTATGTTGGGCTGTGAACCCCAACTGGGGCTATGGAGTTCATTTGCATTTCTTAGATTGCAGTAGGCAAGCTGATGGTTAACATAAGAACTTGCTTC	TTCTCCCCAGGAGTCAAATT
MKSR_Target39	CTTCTCTGTGCCTCAGTTTACTCATTTATAAACTGTGGGAAATAATAGTATCTATCTCAGAGTTTCCACAAAAATCAAATGAGCTAATTGAAGTACTCAGAAAACTGTCTTGTAACTATTAAGGGCTAACTAGGTGCTCAACACCACCCTCTAGATAAATTTTAAAAAGAAAATGGGAATTTGGTAACATATTTGTTTTAAAAAATAAGTGTCCTTCATCTTCTATGGCACAAA	GTTTCCACAAAAATCAAATG
MKSR_Target41	GTTTAAAAGTGTATGTCACCTCGCTGTCTCTCTCTTGCTCCTGTTTGTGCCATGTGACATGCCTCCTTCCCCTTCATCTTCTGCCATGAATGGAAGCTTCCTGAAGTCTCCACAGAAGCCAGGTAGACATCAGCACCATGCTTCCTCTAAAGCCTACAGAACCATGAGT	GTCTCCACAGAAGCCAGGTA
MKSR_Target42	AGCTATAATATGCCATGTATAGTGCTAGCTTTCTGTGATAGATTATCTTCTTCACAAAAAGCAAATACACTGTAGTTCTGGGAAATGTTATCTTTCTCCAGCTAGTTATTATAAAAGCACTCAAGAAACTGAGACAGTTAAATTAACAAAAGATCTTTAATGTTTCTGTTTATCCAATATAAGGAAGTCTATTTATGGAGTATTGATGTGTGCATTATCTTCAAACGAAAAGC	TTCTTCACAAAAAGCAAATA
MKSR_Target43	AATAAAACAAAAACGCAGCCTATGGGATGGGAGAAAATATTTGCAAATCAAACATTTGATAGTTAATATCCAAAATATGTGAAAAACTTCTACAACTCAATCACAAAAATAATAATCTGATTTAAAAATCAGCAAGGGACCTGAATAGACATTTCTCCAAAGAAGACAGATAAACATCCAACAGGTGCATGAAGAGGTGCGTACCATCACTAATCATCAGGGA	TTCTCCAAAGAAGACAGATA
MKSR_Target46	TCAGAATGCTTAACACTTTAGCAAGCCAATTTTCGGTCATTGTTAACACCTGAGGGTAAATTATTTGCATTTTTCTTAAGAGGCAATCAGGTGAGGCAAATTCTCCATAAGAGTAAAATACACAAAAAGGAAAATCAGGTGGAAGAAATTGAGGTGGACAATCTGGCAATGCCTAAGGGAATACTGGCCAACCTGAGGTCATCTTGAGGACCAGAAAGGAAAGGTCCAGGATAGGGTTGTTTAAAAG	TTCTCCATAAGAGTAAAATA
MKSR_Target47	GGTAAACACTTTCTTCCCAAAAGGGAGAAATAAGGCAAAAGAAAGGAAAGCCATACTCCACAGAAGTCAAAAATGCAGCAGGGCTGACATTAAATCTTAAAGCTCCAAAATAATCTCCTTTGACTTCATGTCCTGCATCTGGGCACGCTGTTGCTAGGGGTGGTCTCCCAAGGAATCCCTGCCCCATGGCTTTGTTGGATGCAACCCATGTGACTATTCTCACAAGTTGGAGTTG	TACTCCACAGAAGTCAAAAA
MKSR_Target48	GACATGAATCAGACTCATCTGGACAGTATTTCTAAAATTCAGGTACTAAGTTATATATTTAGTAGAATTTGGAGGTGGAAGGCAGATTGCAGGAATATGTAATTTGAGAAAGTTCTCCAAAAGATTCAAATGTGCACCCCTAGTTAAAAAAAAAACAAACTCAGATATGGGCCAATTTTCTTG	TTCTCCAAAAGATTCAAATG
MKSR_Target49	CAACATAAACACCGGCTGTTGTTACTATTATTGTTACTGGTCAGGTGCTGGGCTGGGAGCTGGGGATGGAATTACGAGCAGTGGGGAGTTGTTGGGGTGGCTGCTTATTATTTCTTGTCTTCCCCACCAGAGTCAAGTACACAGAGTAACTTAGAACATAAGGCAACTTCTCTATCCTCTC	TTCCCCACCAGAGTCAAGTA
MKSR_Target50	CAATACATGCAAGACCTCCTTTGGCAAAACAAAAAGGCTCTAAGTAAACAAAATTTCTGCTCAAAAGTCAGATACACAGTGATGATTTTTCTGTGTATAGTCATGAATTACATCTATTCTTTTAATAGCTAACTAATGTTCATATGTAATTATAGTTCATAGTTCTCTTTAAGTATTGTACTCACTTTTTTATTGCCAGCATCAATGGAAACTATTTTCAGAAGGCAGCG	TTCTGCTCAAAAGTCAGATA
MKSR_Target51	GCTCCCTTGAGTCACTATAAGCAATTTATGAGAAAAATTTTATCTATTTTCCACAGGAATCAAGCATGCACCTGGGTATATTTGCCATTCCCTCCAGCTGGTGTGCCCTTCCTCACTATTCTAACCAATATTCAAGGCACACCTTTATACCACCTTCTATATGAAACCTTTTCTGAATCTCTTTAGGAGGACCTACATC	TTTTCCACAGGAATCAAGCA
MKSR_Target52	CTTCTGAGAAACAAGATTCAGGCGTCCGCCCCTGACTCCTGCCCATCCCCCACAGAAGTCAGATGGACCGCTCTCCAGTCCCTCTTTACCTTTGATCAAATTCGGAAGTCTCGGCCCACTAAGGATCGCTCCTGGTTCCTCGGAACCCTGAGTCCAAACGTCCTAGCTCACCAATAGACTACC	TCCCCCACAGAAGTCAGATG
MKSR_Target53	GTTTAGGTCTGTCATGAGAAGTTTATCAGAAATAAAGGATTGTTTAGTGCTTCCAAAAGTTATGTAGTATAATAGTGTAAAATTAAGCTAAGTGACTTTTCACCATAAAAGTCAAGTAAACTCACTAACACCAAGCATAAACAGAAAAACTCACAGACCTGTATTATAAGGCATTCCATCTGAG	TTCACCATAAAAGTCAAGTA
MKSR_Target54	CATCCTGAAGTACAGCGGCTCCATCGCCACCCTGGAGCGCCTGCAGAGCTTCCGGCCCTTGCCAGAGCCTCTGACAGTGCAGCTCCTGACAGTCCCTGGCGAGGTCTTCCCCCCAAAAGTCAAATACACCTTCTTTGTTCCTAATGACGTGGACTTTAGCATGCAGAG	TTCCCCCCAAAAGTCAAATA
MKSR_Target55	ACCTGGTGATGTCTTGAAGTAGTGCTAGATAAATAGATTATGCCTCACCTGCTCTTCTGAACAAGAATCAGATGCGCTCTCCTCAGGGCCACTTCATGAGGAGAAGCCCTGAGTTTCAAATTGAGAGCCAGGGGACATATCTCTTCTCTCTTATTCCCTTCCACTGCCCTCTTCTCCCATTTGAGGCTTCACTGGGACCTAGAACCTGCTTGTTAG	TTCTGAACAAGAATCAGATG
MKSR_Target56	GGTAAGATGTGTGTTTGCATGAGAGACCAGCTCATTATTCTTCTAAAACCAAATTTGGGCTCCAGTCCAGTTCACCGAAGCTGTCTGTGCCCTTCGAGGCCATCCTGGAGTTTGAGGAATGGTTGGCCACAGAAATCAAATAGGCTTAATACATTGGCTGGGAAATTGAGACATCAGAGACTATTCCACACC	TTGGCCACAGAAATCAAATA
MKSR_Target57	ACACACACGCTTTCTTCCCAAGGTGGATAGTAGTATATTTGAATAATGAATACAGGACACTACATATAGCACATTTGTGTAAAGCAAACTTCTCCACAAAATGCAAATAAACCTCTTTCTCCATGTAATTCCCAGCTCTTGATCCACTGCTCTGGTTCTTCCC	TTCTCCACAAAATGCAAATA
MKSR_Target58	GCTACACCAACTCCTCATAAACCACATGGACTTTCTGGACTTTATTTCCCCACAGAAGACAAATACACAAAAGCCCTCGTATGACATGTTTTCCCCATCCTTCAGCTTCCCAGTCTTGGCCCACTCCTCATACCATCTTTACTGCCACCTTGAACCTATGAGTAAGGTGGAAATC	TTCCCCACAGAAGACAAATA
MKSR_Target60	ATGTCCAGAATGCATACAAACACATCCTTTAAAAACAAAGAAAAGGAATGAGAAGGGAGGGGAGGGGAGGAGAGAAGGAGAGGGGCGGAAAAAGAGAACAAATTTCCTATTAAAGTTGGGGTGTGCTAATTTCTCCACAAAAGCCAGTTAGACCCACCCATGGCTTAAAAGGGGAGAAAGAGAGGTGGGGCAGGGGCGGGGGAGGGGGAGGAAGCAAAAGAGGAAGAGTAGAATC	TTCTCCACAAAAGCCAGTTA
MKSR_Target61	CTGTCAAAAGTCTAAGACAAAGAGAGAGTTTTAAAAACACCAAAAGTATCAAGTCACATATAAAGGAATTTCTGTCAGACTAACAGCTGATTTCTCCACAGAAATCCTATAAACCAGGAGAGAATTAGATGATATATTCAAAGTGCTGAGGGGTTGGGGGGAAGAACTGTTAGGCAAGAATACTATACCC	TTCTCCACAGAAATCCTATA
MKSR_Target62	CTCTCGGCCCTTACTCTCTCCAGTGTAGTCCCACTGGCTCCTTGCTGTTCTCCACACACATCAGATGTGCTGACATGGAATCCTTGCAGTTGCTGTTCCCCTCCCTGAATGCTCTTCCCTTCCTGGCTTGGTCTCATTCCCTCACCTCATTCTGGCCA	TTCTCCACACACATCAGATG
MKSR_Target63	GTAGGGATCTTTTCTTACACCTTCTTGTAGCTTCAGCATGTTTTGATAAATATTTGCTAGTGTTTGACAAATAAATGCTTTCTCCTCAAATATCAAATATACAAATTGGAGCTTTCCCCAAGAAGCATACTTCTCAACTCTCTTGGATCTCTCTGTTAAGATGCCAC	TTCTCCTCAAATATCAAATA
MKSR_Target64	GCATACTCTGGACCGAGATTATAGATAGAATGAACTATAAAAAGTCCAAATAAACCCTCCAGAGAATGCTGAGACCTTGGCTTTCTGATTCTCCACATAAGTTAAATAGGCCCCACAGGAGGCCCCCACTGCAACACGCAGTTGGTTCAGTGCTAGATTAGTCATCGTTAGAAGATGGCCAGAATTCAG	TTCTCCACATAAGTTAAATA
MKSR_Target65	GAAGATAGCAGATGTCTGTTAGCCCATGGACAATGTGCAAATGCATTGCTGAGGTGGGGGTGAAGGCCAGGCCTTGGAAAACAACAGAAGGAAATCGTGGATAAAAATCCCTCTGTATAGATGGTAGTCCCAGTGTGATGAGGCATTTTTTTCCACAAAATTCAAATATACAAGTTTAAAGAAAGGATACATTAAGAAGATGAAAGTGTGAATAGTAATAGTGACCAATGCTGC	TTTTCCACAAAATTCAAATA
MKSR_Target66	AAGGCTTTTTAGAGAATGGCAATTGCTGAAAACAAAGCTTGAAGTGGGAAAATATTAAATTTTTTTCTCCACAAAAGTAAGGAAGGCACAATGAAATACCATTTTCATGCCACTAGGATGGCTATAATAATAATTCATTAATCAAATAGGAAATAAGGCCAGTGTGTGG	TTCTCCACAAAAGTAAGGAA
MKSR_Target68	TCAGGACACACCAGTTCTTTCCAGTGTCCTGGGAATCTGGAAAATGCTAATCCATCATTATCTCAGGCTGCAAAGAACTCCTTTTTCTCCCAAGAAATCAAATGAACCCTCACATGTTGGGTGTGTTTGCGCGTGTTTCCTGCAAGCTGAGGCATGGATTTCGAGAAGTA	TTCTCCCAAGAAATCAAATG
MKSR_Target69	GAGAAAAATAGCTTACCTGTAGAGGAGCAAAGATAAAAATTCTATCTGACTTCTCCTCAGAAATCATATAAGCAAAAAGAGAGCACAGCAAAATATTTACAGTATTGGGAGAAAAACAACATAAAATTTTACACTCTGTGTAATTATCCTTCAAAAATGAAGGATAAATACTGTATCCAAAAATCAAAAATTGAAAAAAATTGTTGCCAGTAAACCTGCCTTGTAAGTAATATT	TTCTCCTCAGAAATCATATA
MKSR_Target70	TGTCAATAATCCCTACCATGATTGGAGTATTTAAAACTAATACCTTTTTAACCTCCATATTTCATATTTTTACTTGCTATGAATTATTTTCCTCAGGAATCAAATACACTATTCAAATACATATAATGTGATTATATATTATGTTTATGCATTATTCTGTTTCTATCACAAGTTTTATTTAGCTTTATTAGGGCAATACTTTTTGGCTA	TTTTCCTCAGGAATCAAATA
MKSR_Target71	GTAGCAAATGAAGACCACCTTCTTCTCAATTTGTGATTAACACTGGCAAAGTACATATGCTATGAAGTTTGTGTATCAGATGAGTAAAATGTACTCCACAAAAAACAAGTGAACTGAAACAAATTCACAAAGTCTTTTAAAATACTTTCCTTCTTGCCTAAGATATAACCAAGGCTGG	TACTCCACAAAAAACAAGTG
MKSR_Target72	GCTTCAGGTAAGTATCTTTGATGAACAGTGATGCAAAAAATTTCAACAAAATACTGGCAAACCAAATTCAGCAGCAAATGAAAAAACTTATCCACCAGAATCAGGTAGGCTTCATCTCTGAAATGCAAGGTTGGTTGAACATACTGAAATTAAGAAATATTATTCAGGCCAGC	TTATCCACCAGAATCAGGTA
MKSR_Target73	ATCCTTAACAAAATACTGGCAAACTGAATCCAGCAGCACATCAGAATGCTTATCCACCAAAATCAAGTAGGCTTCACCTCCGGGATGCAAGGTTAGTTCAACATATGCAAATCAATAAATGTGACTCATCACATAAACAGAACCAAAGGCAAAAACCACATAATAATCTCAACAGATGCAGAAA	TTATCCACCAAAATCAAGTA
MKSR_Target74	CTCAGGTATTTCTTTATAGCAATGCACGACAATATTCAAAGTTAAGAAAATCAAAGATAAACAATCTTGAAAGAAGTAAAAAAGCACCTTACTTATAGGAGAGAAAATAATTAAATCCAACTTCTCCTCAGAAACCAGGTAAACAAGAATAGAGCAGGGTGAAATAGTTAAAGTATTGAGATTAAAAAACCACCAGCCTAGAATTCTGTACCCAGCAAAAT	TTCTCCTCAGAAACCAGGTA
MKSR_Target75	CAAGACTGCATCTCAAAAACAACAAAAAAAAGACAATGTCCTAGAATTTTAAAAATTCAAGCCTTTGATTTTAGCATATTTTCAATTATTATTTGCCTTTTTTCCATAAAAGTCAAGTGCACTGTATCAGTCAAGGTCCAGCCAGAAGACAATCACACAGTAAGTCCAACA	TTTTCCATAAAAGTCAAGTG
MKSR_Target76	AACAGAGTGAGACTCCGTCCCCCTGCCTCCCGCCCCCCCCCGCCCCGCTGCCAAAAAAAAAGAAAGAATTCTTCTCCACAAGTACCAAATGCACAAGTGGGCTTTTTTGCATCTACGAAGGCATACCTGTTGTCTTTGTGATGCTGATGAAAGGCATGTTCCTT	TTCTCCACAAGTACCAAATG
MKSR_Target77	ACAAACAGGATATTCACATGCAGCTTCATCCCCCTTTTGAAAAAATAAAGACAGATAAAGCACTGCATAGTCTCCAACCTCCATTCTCCAGAAGAGTCAAGAAGACACTCACCTTGACCTCAAACTCGAAGTGTGCATCCTTTCCTTGCCCGCAGAGGACGTAGCGTGGGATACTAAT	TTCTCCAGAAGAGTCAAGAA
MKSR_Target78	TCTGACCAACACCATGAATTTCCAGAACCCCAGTCCTTTATCACCAACATCATTCTCCACAAAATTTAAGTAGGCTGTGCACTATTCTTACAGGGTCCAATGAGGAAATAGTCTTATAAACTAAGTTAGGCTAAATTGTTAATAGCTAATGATGACTTAGCTTCCCATATGCAC	TTCTCCACAAAATTTAAGTA
MKSR_Target79	CTCAACCAGGAGCCAATAGTACCTTTTTTTATTTTAAAATGAACAGGAACTTTATTATAAGTTAACAGAGACTTTTACTCTATTCATAGAATTAAATTTGTCAGGATTCTCCAGAGAAATCAAATGCGCATGTGTGTGTGTGTGTGTGTGTGTGCGTGTGTGTGTGTATTTAA	TTCTCCAGAGAAATCAAATG
MKSR_Target80	TTTCTTTTCTAAATGAGGAAATAAGGAGAATATTATGGAATGATTTTTATTCTTCACAGAAGTAAAATAAGCATAGTGTGTTTTGAGTGTTAAGACACAAATGCAATTTCTCCTTTACCTTACTCCAAGCTTGTTTGTATGGAGAAGTTAAGATCATCCCATCTCTATGTTATGCC	TTCTTCACAGAAGTAAAATA
MKSR_Target81	TGCCTGTAACTCCAACACTTAGGGAGGCAGAGGCAGGAGGATAGCTTGAGCCCAGGAGTTTGAGACCAGCCTACGCAACACAGTGAGACCCCATTCTCCACAAAAAGCAAACAAACAAACAAAAAATTCGTCCTATATAAAATTATTTCCATCCATCCATTTGTCATGCAAATAGCTATTCATCCTTCCATCTCTCTATCCAGGTAAGTGTCTGTGATG	TTCTCCACAAAAAGCAAACA
MKSR_Target82	CAAGTCAGAAAACATCCTTGCCTTTTCAGTTTTCTGAAAAAAGTGTTTGTAGAATTGGTATTATTTCTTTTTAAAAATTTTAACAGAATTCTCCAGTAAAGTCAAGTGTACCTGGAGTTTTCTTTGCAGGAATTCTTTAACCTATAAACTCAATTTTGTTAATAGACATAATGCTTTCAGGC	TTCTCCAGTAAAGTCAAGTG
MKSR_Target83	TCTGCAGCTGAGCAAGACAGGAGGGCTTTGAAGGGAGGTCTGTGGTGGGAAGGATGACTTGGCTTCTCCTCAAAGGTCAGGTGCACAAATGCAGCTGAAATTATTCCTCTTCCATATTGTCATTTCCTTCACAAATGCTCATAATTTGGAAGAAAGTTCAATAACCTATTTTTCATCATTAATTTATTCACTGAAGATATTTGCTGGGTACCTACTGGGTGAAAGGCACAGA	TTCTCCTCAAAGGTCAGGTG
MKSR_Target84	AGGTAACAGTGAAGTTTCTATTTGTGCCATATTAGCAGGAACTGTGGGATAATGTTTAAAGGCTTTGAGTATCTTAGAACTCCAAACCAGTTGTAACCCTTGATTTTCCACAAGTATCAAATAAACTCTAGATCTAGTTAATTCCCTCTTGAAATTCAAAAGAGGGAAGGGAAGGGAAGGGAATTAAATGATTAAATGTATTGAGGGCCTGCTATAAACAAGGTACCATGTCAAAT	TTTTCCACAAGTATCAAATA
MKSR_Target85	AGGCAAACTCAAGGCAAATCCCTGAGCTGGCCTCTCAGACCCATGGCTCCACCTCAGCCAGCTGTGTGTCTTTGGGCAAGCCCTTCCTTCTCTCCAGGCCTTAGTCTCCCCAGGAGTCAAATGGGCTCCAGAACCCCATCCACCTCCCAAGTGTGTTCTGAAATGGGGACAGTAGAGAGGACTTGTC	GTCTCCCCAGGAGTCAAATG
MKSR_Target86	AAATTCAGGCCAATATCCATGACAAACATTGATGCAAAAATCCTCAACAAAATACTGGCAAACTGAATCCAGCAGCACATCAGAAAGATTATCCACAAAGATCAAATATGCTTCATCCCAGGGATGCAAGGTTTCTTTAACATACACAAATCAGTAAATGTGATTCATCACATAAATAGAACAAAAGACAAAACCACATGATTAGCTCAACAGATGCAGAAAAG	TTATCCACAAAGATCAAATA
MKSR_Target87	ATGGTGAAAGAAAACATGTGGAAAACTGTAAAACTAGAAAGAATTCTCGACAAAAAACAGATACACATACCATAACTAAAAGGAACTACACTTAATTAAATGTACACTACATCTGGAATATCAGCCTAATAAAATGTGAAACTATTAATTTTCATTGTTCTAAAGGAAATGAGGTCAGTG	TTCTCGACAAAAAACAGATA
MKSR_Target88	CATTCTTTAACCTCTCTGGGCCTCAGATAAACTTTCTCATCTATAACACAGGAGAAAAATCCCTTCCCCAGCTACCTCTCAGTTCTTCATAAAAATCAAATAAGCTAATGGGTATGAAAGTGCTTTGCAGACTAAGAAGTGCCTTGCAGGTGTGATGGCTACCTTTTGTTATTATGGATGGAGGCATTAGTCTTTTCTCTGTTCCTGGGACTTGCTGGCAGAATGAGTTAGTGCAAAC	TTCTTCATAAAAATCAAATA
MKSR_Target89	CTTCACAAGGAGTCCGATATTTACACCAGCTAATATTCTCATAGTAAGAGTTGAAAGGTGCATCATTAATTGGTTTATAGAAATTACATCTTGCTGATGTCAAATAAAGGGACACAGTGAATGCAACTTTCACAACAAAAATCAAATACACATAGCACCAGGGATCCAATTAAGTATTCAAAGTTAAGAATTAAAGGACACTTAGTTGCTGGGTGTAGCAACTAAGAGACTTT	TTCACAACAAAAATCAAATA
MKSR_Target90	TGTTATTGTACACACACCAATGTCCAGGAGAGATACTTCATAATAAGTTGATGCAGTTGTGTAGTCTGCTCAGTAGAACTATTTCTACACAGAAGACAGATGTACTACAAATGACTTGATGACACTGATCATTAATATCTTCAGTGATTCCTTTCGCTACGATTCGTACTTAACACACAATGTATTGATTAGAAGTTTCCTCCTGATAAAACTTTCTTCCTGGAAGATATTGCACTCTTCAAC	TTCTACACAGAAGACAGATG
MKSR_Target91	TGCCAGTCACAGTGCTAAGCAGAAGATACAAGTTGAGTAAGACAGTCTTGTCCTCAAGAATCAGATAAGCATGAGTAATTCTTGAATTTAGCTGTTAACGAAGGAAAAATATAGATAAATAATATCTGTAGATAATCTCTTCTTTCTCTGTCCTTTGGAATAGCCA	TTGTCCTCAAGAATCAGATA
MKSR_Target93	CTAAATTAGCAGAACCCAAGAAAGTCCAGGAGACAGATCATGGATGAAGAGAATGGTGGGAAGTGACAGCCCTGCTGTCTGTTTTTCATTCTCCACTAAAACCAAGTGTGCAGGCCACAGACAAAATCAAAAGTCCAAAAGAACTTGTACAGCATTTAACAGTTTATTGGGTCCTGA	TTCTCCACTAAAACCAAGTG
MKSR_Target94	GAAGAAACCTGGTACCTTTTACCATAACAAACTCACTTAAATGTTTTAAGAGAAAGGGCTAAAATAAACATTAATTTAAGTGAATCTATTTTTTTCTCCACAAAAATCGGAGGTACCAAAGTCATAATAAAATGAAAGTAAAAGGACATTAACAGAAATACAAAGATAATTATGAAAAAGAAGGAATTTCATTGTTTTTGTTAAAGGGTAAAGGCAAAGAGAGAAGAAAAGATC	TTCTCCACAAAAATCGGAGG
MKSR_Target96	CAAAATTTGCAGGTAGAAATCCGCTTCCTACACAGTTTCAGCTTTCTCCAAAAATATCAGATACGCAGAAAATAAAATAGAAAACATTCTGCCTTGATGAGTAGAAAAATGATTCTAGAAAAGGGTAGGAAATCCCCTTCTGAATCCAGGTGTTTCAACTTCATTGAATACTGCTGTGTGGTTTGTTAC	TTCTCCAAAAATATCAGATA
MKSR_Target97	GTCTGTTTTACTCTTCAAAGGTCTGGTTGGGTTGAATGCTGGACTGTCCCAAGTGTCATGCTTACAATTGATTATACATGGCATCCAATTTATCCACAAAAAGCAGATGAACAGCTGAAACAATCATGTAAGTGTTTTTATATAATTTGTGCTTTTATACAGCTGCTATTATG	TTATCCACAAAAAGCAGATG
MKSR_Target98	AGCCTAGAACTAGCTCAGATGGTTCACATTCTCTGTAGTTTCCTCACCTCTTTACTACCTTCTTTCTTCACAGAAATTAAGTACACAGTAGTCTTTTCTCTCCAGCCTAGTCTCTGAGTTGGACTCATTGCCAAATCAATTTGTGATACCACTAAAAGAAGGAAGCTACATTTTGCTGATGGT	TTCTTCACAGAAATTAAGTA
MKSR_Target99	GTACCACAACATAATAAAGGTCTTTCCCATACTTAAAAATATTATTGCAATTTCTAGTTCCATGTAAATATTTACTCTTATACTTTATTTTGTTTGTTCATTTTGTTTTAAATTCTCAACACAAATCAGGTAAGCTTCAGGCTTGAGAGGTAGAGGCAGTCATAAAAGACTTCTTCTCCAT	TTCTCAACACAAATCAGGTA
